index;budget;genres;original_title;popularity;revenue;runtime;title;vote_average;profit
0;237000000;Action Adventure Fantasy Science Fiction;Avatar;150437577;2787965087;1620;Avatar;72;2550965087
1;300000000;Adventure Fantasy Action;Pirates of the Caribbean: At World's End;139082615;961000000;1690;Pirates of the Caribbean: At World's End;69;661000000
2;245000000;Action Adventure Crime;Spectre;1,07E+16;880674609;1480;Spectre;63;635674609
3;250000000;Action Crime Drama Thriller;The Dark Knight Rises;11231295;1084939099;1650;The Dark Knight Rises;76;834939099
4;260000000;Action Adventure Science Fiction;John Carter;43926995;284139100;1320;John Carter;61;24139100
5;258000000;Fantasy Action Adventure;Spider-Man 3;1,16E+16;890871626;1390;Spider-Man 3;59;632871626
6;260000000;Animation Family;Tangled;48681969;591794936;1000;Tangled;74;331794936
7;280000000;Action Adventure Science Fiction;Avengers: Age of Ultron;1,34E+16;1405403694;1410;Avengers: Age of Ultron;73;1125403694
8;250000000;Adventure Fantasy Family;Harry Potter and the Half-Blood Prince;98885637;933959197;1530;Harry Potter and the Half-Blood Prince;74;683959197
9;250000000;Action Adventure Fantasy;Batman v Superman: Dawn of Justice;155790452;873260194;1510;Batman v Superman: Dawn of Justice;57;623260194
10;270000000;Adventure Fantasy Action Science Fiction;Superman Returns;57925623;391081192;1540;Superman Returns;54;121081192
11;200000000;Adventure Action Thriller Crime;Quantum of Solace;1,08E+16;586090727;1060;Quantum of Solace;61;386090727
12;200000000;Adventure Fantasy Action;Pirates of the Caribbean: Dead Man's Chest;1,46E+16;1065659812;1510;Pirates of the Caribbean: Dead Man's Chest;70;865659812
13;255000000;Action Adventure Western;The Lone Ranger;49046956;89289910;1490;The Lone Ranger;59;-165710090
14;225000000;Action Adventure Fantasy Science Fiction;Man of Steel;99398009;662845518;1430;Man of Steel;65;437845518
15;225000000;Adventure Family Fantasy;The Chronicles of Narnia: Prince Caspian;53978602;419651413;1500;The Chronicles of Narnia: Prince Caspian;63;194651413
16;220000000;Science Fiction Action Adventure;The Avengers;144448633;1519557910;1430;The Avengers;74;1299557910
17;380000000;Adventure Action Fantasy;Pirates of the Caribbean: On Stranger Tides;135413856;1045713802;1360;Pirates of the Caribbean: On Stranger Tides;64;665713802
18;225000000;Action Comedy Science Fiction;Men in Black 3;52035179;624026776;1060;Men in Black 3;62;399026776
19;250000000;Action Adventure Fantasy;The Hobbit: The Battle of the Five Armies;1,21E+16;956019788;1440;The Hobbit: The Battle of the Five Armies;71;706019788
20;215000000;Action Adventure Fantasy;The Amazing Spider-Man;89866276;752215857;1360;The Amazing Spider-Man;65;537215857
21;200000000;Action Adventure;Robin Hood;37668301;310669540;1400;Robin Hood;62;110669540
22;250000000;Adventure Fantasy;The Hobbit: The Desolation of Smaug;94370564;958400000;1610;The Hobbit: The Desolation of Smaug;76;708400000
23;180000000;Adventure Fantasy;The Golden Compass;42990906;372234864;1130;The Golden Compass;58;192234864
24;207000000;Adventure Drama Action;King Kong;6,12E+16;550000000;1870;King Kong;66;343000000
25;200000000;Drama Romance Thriller;Titanic;100025899;1845034188;1940;Titanic;75;1645034188
26;250000000;Adventure Action Science Fiction;Captain America: Civil War;1,98E+16;1153304495;1470;Captain America: Civil War;71;903304495
27;209000000;Thriller Action Adventure Science Fiction;Battleship;64928382;303025485;1310;Battleship;55;94025485
28;150000000;Action Adventure Science Fiction Thriller;Jurassic World;418708552;1513528810;1240;Jurassic World;65;1363528810
29;200000000;Action Adventure Thriller;Skyfall;93004993;1108561013;1430;Skyfall;69;908561013
30;200000000;Action Adventure Fantasy;Spider-Man 2;35149586;783766341;1270;Spider-Man 2;67;583766341
31;200000000;Action Adventure Science Fiction;Iron Man 3;7768208;1215439994;1300;Iron Man 3;68;1015439994
32;200000000;Family Fantasy Adventure;Alice in Wonderland;78530105;1025491110;1080;Alice in Wonderland;64;825491110
33;210000000;Adventure Action Science Fiction Thriller;X-Men: The Last Stand;3857526;459359555;1040;X-Men: The Last Stand;63;249359555
34;200000000;Animation Family;Monsters University;89186492;743559607;1040;Monsters University;70;543559607
35;150000000;Science Fiction Action Adventure;Transformers: Revenge of the Fallen;21939663;836297228;1500;Transformers: Revenge of the Fallen;60;686297228
36;210000000;Science Fiction Action Adventure;Transformers: Age of Extinction;116840296;1091405097;1650;Transformers: Age of Extinction;58;881405097
37;200000000;Fantasy Adventure Family;Oz: The Great and Powerful;46985445;491868548;1300;Oz: The Great and Powerful;57;291868548
38;200000000;Action Adventure Fantasy;The Amazing Spider-Man 2;89270217;705717432;1420;The Amazing Spider-Man 2;65;505717432
39;170000000;Adventure Action Science Fiction;TRON: Legacy;7379505;400062763;1250;TRON: Legacy;63;230062763
40;200000000;Animation Family Adventure Comedy;Cars 2;4998659;559852396;1060;Cars 2;58;359852396
41;200000000;Adventure Action Thriller Science Fiction;Green Lantern;51872839;219851172;1140;Green Lantern;51;19851172
42;200000000;Animation Family Comedy;Toy Story 3;6,00E+15;1066969703;1030;Toy Story 3;76;866969703
43;200000000;Action Science Fiction Thriller;Terminator Salvation;71862892;371353001;1150;Terminator Salvation;59;171353001
44;190000000;Action;Furious 7;1,02E+16;1506249360;1370;Furious 7;73;1316249360
45;200000000;Action Drama Horror Science Fiction Thriller;World War Z;81834855;531865000;1160;World War Z;67;331865000
46;250000000;Action Adventure Fantasy Science Fiction;X-Men: Days of Future Past;1,18E+16;747862775;1310;X-Men: Days of Future Past;75;497862775
47;190000000;Action Adventure Science Fiction;Star Trek Into Darkness;7,83E+15;467365246;1320;Star Trek Into Darkness;74;277365246
48;195000000;Action Family Fantasy;Jack the Giant Slayer;43349855;197687603;1140;Jack the Giant Slayer;55;2687603
49;105000000;Drama Romance;The Great Gatsby;6,12E+16;351040419;1430;The Great Gatsby;73;246040419
50;150000000;Adventure Fantasy Action Romance;Prince of Persia: The Sands of Time;6,22E+16;335154643;1160;Prince of Persia: The Sands of Time;62;185154643
51;180000000;Action Science Fiction Adventure;Pacific Rim;5,65E+16;407602906;1310;Pacific Rim;67;227602906
52;195000000;Action Science Fiction Adventure;Transformers: Dark of the Moon;2,85E+16;1123746996;1540;Transformers: Dark of the Moon;61;928746996
53;185000000;Adventure Action;Indiana Jones and the Kingdom of the Crystal Skull;75674458;786636033;1220;Indiana Jones and the Kingdom of the Crystal Skull;57;601636033
54;175000000;Adventure Animation Family;The Good Dinosaur;51692953;331926147;930;The Good Dinosaur;66;156926147
55;185000000;Animation Adventure Comedy Family Action;Brave;125114374;538983207;930;Brave;67;353983207
56;185000000;Action Adventure Science Fiction;Star Trek Beyond;65352913;343471816;1220;Star Trek Beyond;66;158471816
57;180000000;Animation Family;WALL·E;66390712;521311860;980;WALL·E;78;341311860
58;140000000;Action Comedy Crime Thriller;Rush Hour 3;2257178;258022233;910;Rush Hour 3;61;118022233
59;200000000;Action Adventure Science Fiction;2012;45274225;769653595;1580;2012;56;569653595
60;200000000;Animation Drama;A Christmas Carol;39744242;325233863;960;A Christmas Carol;66;125233863
61;176000003;Science Fiction Fantasy Action Adventure;Jupiter Ascending;8,54E+15;183987723;1240;Jupiter Ascending;52;7987720
62;180000000;Action Adventure;The Legend of Tarzan;42741719;356743061;1090;The Legend of Tarzan;55;176743061
63;180000000;Adventure Family Fantasy;The Chronicles of Narnia: The Lion, the Witch and the Wardrobe;67391328;748806957;1430;The Chronicles of Narnia: The Lion, the Witch and the Wardrobe;67;568806957
64;178000000;Science Fiction;X-Men: Apocalypse;139272042;543934787;1440;X-Men: Apocalypse;64;365934787
65;185000000;Drama Action Crime Thriller;The Dark Knight;187322927;1004558444;1520;The Dark Knight;82;819558444
66;175000000;Animation Comedy Family Adventure;Up;92201962;735099082;960;Up;77;560099082
67;175000000;Animation Family Adventure Science Fiction;Monsters vs Aliens;3,62E+16;381509870;940;Monsters vs Aliens;60;206509870
68;140000000;Action Science Fiction Adventure;Iron Man;120725053;585174222;1260;Iron Man;74;445174222
69;170000000;Adventure Drama Family;Hugo;32319043;185770160;1260;Hugo;70;15770160
70;170000000;Action Adventure Comedy Science Fiction Western;Wild Wild West;4,07E+16;222104681;1060;Wild Wild West;51;52104681
71;145000000;Adventure Action Fantasy;The Mummy: Tomb of the Dragon Emperor;60034162;401128639;1120;The Mummy: Tomb of the Dragon Emperor;52;256128639
72;175000000;Action Adventure Crime Fantasy Science Fiction;Suicide Squad;9,02E+15;745000000;1230;Suicide Squad;59;570000000
73;175000000;Fantasy Comedy Family;Evan Almighty;27082182;173000000;960;Evan Almighty;53;-2000000
74;178000000;Action Science Fiction;Edge of Tomorrow;79456485;370541256;1130;Edge of Tomorrow;76;192541256
75;175000000;Adventure Action;Waterworld;4,46E+16;264218220;1350;Waterworld;59;89218220
76;175000000;Adventure Action Thriller Science Fiction;G.I. Joe: The Rise of Cobra;32852443;302469017;1180;G.I. Joe: The Rise of Cobra;56;127469017
77;175000000;Drama Comedy Animation Family;Inside Out;1,29E+16;857611174;940;Inside Out;80;682611174
78;175000000;Family Adventure Drama Fantasy;The Jungle Book;9,42E+15;966550600;1060;The Jungle Book;67;791550600
79;200000000;Adventure Action Science Fiction;Iron Man 2;7,73E+15;623933331;1240;Iron Man 2;66;423933331
80;170000000;Adventure Fantasy Drama;Snow White and the Huntsman;77178973;396600000;1270;Snow White and the Huntsman;58;226600000
81;180000000;Fantasy Adventure Action Family Romance;Maleficent;1,11E+16;758539785;970;Maleficent;70;578539785
82;170000000;Science Fiction Action Drama Thriller;Dawn of the Planet of the Apes;2,44E+16;710644566;1300;Dawn of the Planet of the Apes;73;540644566
83;27000000;Action Adventure Science Fiction Romance;The Lovers;2418535;0;1090;The Lovers;48;-27000000
84;175000000;Drama Action Adventure Fantasy;47 Ronin;41796339;150962475;1190;47 Ronin;59;-24037525
85;170000000;Action Adventure Science Fiction;Captain America: The Winter Soldier;7,22E+15;714766572;1360;Captain America: The Winter Soldier;76;544766572
86;165000000;Comedy Adventure Fantasy Animation Family;Shrek Forever After;4,40E+16;752600867;930;Shrek Forever After;60;587600867
87;190000000;Adventure Family Mystery Science Fiction;Tomorrowland;130311355;209154322;1300;Tomorrowland;62;19154322
88;165000000;Adventure Family Animation Action Comedy;Big Hero 6;20373459;652105443;1020;Big Hero 6;78;487105443
89;165000000;Family Animation Comedy Adventure;Wreck-It Ralph;62341073;471222889;1080;Wreck-It Ralph;71;306222889
90;165000000;Adventure Animation Family Fantasy;The Polar Express;47323228;305875730;1000;The Polar Express;64;140875730
91;165000000;Action Adventure Science Fiction;Independence Day: Resurgence;48775723;389681935;1200;Independence Day: Resurgence;49;224681935
92;165000000;Fantasy Adventure Animation Family;How to Train Your Dragon;67263269;494878759;980;How to Train Your Dragon;75;329878759
93;200000000;Action Thriller Science Fiction;Terminator 3: Rise of the Machines;69405188;435000000;1090;Terminator 3: Rise of the Machines;59;235000000
94;170000000;Action Science Fiction Adventure;Guardians of the Galaxy;4,81E+16;773328629;1210;Guardians of the Galaxy;79;603328629
95;165000000;Adventure Drama Science Fiction;Interstellar;724247784;675120017;1690;Interstellar;81;510120017
96;160000000;Action Thriller Science Fiction Mystery Adventure;Inception;16758371;825532764;1480;Inception;81;665532764
97;15000000;Action Adventure Drama Horror Science Fiction;シン・ゴジラ;9,48E+15;77000000;1200;Shin Godzilla;65;62000000
98;250000000;Adventure Fantasy Action;The Hobbit: An Unexpected Journey;108849621;1021103568;1690;The Hobbit: An Unexpected Journey;70;771103568
99;38000000;Action Crime Thriller;The Fast and the Furious;6909942;207283925;1060;The Fast and the Furious;66;169283925
100;150000000;Fantasy Drama Thriller Mystery Romance;The Curious Case of Benjamin Button;6,03E+16;333932083;1660;The Curious Case of Benjamin Button;73;183932083
101;160000000;Action Science Fiction Adventure;X-Men: First Class;3195174;353624124;1320;X-Men: First Class;71;193624124
102;160000000;Action Adventure Science Fiction;The Hunger Games: Mockingjay - Part 2;1,27E+16;653428261;1370;The Hunger Games: Mockingjay - Part 2;66;493428261
103;150000000;Fantasy Adventure Action Comedy Drama;The Sorcerer's Apprentice;35580815;215283742;1090;The Sorcerer's Apprentice;58;65283742
104;160000000;Adventure Action Drama Thriller;Poseidon;21133748;181674817;990;Poseidon;55;21674817
105;170000000;Fantasy;Alice Through the Looking Glass;5,63E+16;299370084;1130;Alice Through the Looking Glass;65;129370084
106;160000000;Fantasy Adventure Animation Comedy Family;Shrek the Third;42986467;798958165;930;Shrek the Third;60;638958165
107;160000000;Action Adventure Fantasy;Warcraft;63148529;433677183;1230;Warcraft;63;273677183
108;155000000;Science Fiction Action Thriller Adventure;Terminator Genisys;2,02E+16;440603537;1260;Terminator Genisys;58;285603537
109;155000000;Adventure Family Fantasy;The Chronicles of Narnia: The Voyage of the Dawn Treader;4,97E+16;415686217;1130;The Chronicles of Narnia: The Voyage of the Dawn Treader;62;260686217
110;140000000;History Romance War;Pearl Harbor;3420669;449220945;1830;Pearl Harbor;66;309220945
111;150000000;Adventure Science Fiction Action;Transformers;25468493;709709780;1440;Transformers;66;559709780
112;155000000;War History Action Adventure Drama;Alexander;3,90E+16;167298192;1750;Alexander;56;12298192
113;150000000;Adventure Fantasy Family Mystery;Harry Potter and the Order of the Phoenix;7,81E+15;938212738;1380;Harry Potter and the Order of the Phoenix;74;788212738
114;150000000;Adventure Fantasy Family;Harry Potter and the Goblet of Fire;101250416;895921036;1570;Harry Potter and the Goblet of Fire;75;745921036
115;150000000;Fantasy Action;Hancock;5,68E+16;624029371;920;Hancock;62;474029371
116;150000000;Drama Horror Action Thriller Science Fiction;I Am Legend;70867401;585349010;1010;I Am Legend;69;435349010
117;150000000;Adventure Comedy Family Fantasy;Charlie and the Chocolate Factory;5,39E+15;474968763;1150;Charlie and the Chocolate Factory;67;324968763
118;150000000;Animation Comedy Family Fantasy;Ratatouille;65677399;623722818;1110;Ratatouille;75;473722818
119;150000000;Action Crime Drama;Batman Begins;115040024;374218673;1400;Batman Begins;75;224218673
120;150000000;Family Animation;Madagascar: Escape 2 Africa;44141021;603900354;890;Madagascar: Escape 2 Africa;62;453900354
121;150000000;Adventure Fantasy Action Comedy Family;Night at the Museum: Battle of the Smithsonian;81781591;413106170;1050;Night at the Museum: Battle of the Smithsonian;59;263106170
122;150000000;Adventure Action Thriller Science Fiction;X-Men Origins: Wolverine;5,95E+15;373062864;1070;X-Men Origins: Wolverine;62;223062864
123;150000000;Adventure Action Thriller Science Fiction;The Matrix Revolutions;73313918;424988211;1290;The Matrix Revolutions;64;274988211
124;150000000;Animation Adventure Family;Frozen;1,65E+16;1274219009;1020;Frozen;73;1124219009
125;150000000;Adventure Action Thriller Science Fiction;The Matrix Reloaded;7078591;738599701;1380;The Matrix Reloaded;67;588599701
126;170000000;Action Adventure Fantasy;Thor: The Dark World;99499595;644571402;1120;Thor: The Dark World;68;474571402
127;150000000;Action Adventure Science Fiction Thriller;Mad Max: Fury Road;4,34E+16;378858340;1200;Mad Max: Fury Road;72;228858340
128;150000000;Thriller Mystery;Angels & Demons;67447636;356613439;1380;Angels & Demons;65;206613439
129;150000000;Adventure Fantasy Action;Thor;86493424;449326618;1150;Thor;66;299326618
130;150000000;Animation Family Adventure Comedy;Bolt;4,18E+16;309979994;980;Bolt;63;159979994
131;150000000;Fantasy Action Adventure Family Comedy;G-Force;2,67E+16;292817841;880;G-Force;51;142817841
132;150000000;Adventure;Wrath of the Titans;4,49E+16;301000000;990;Wrath of the Titans;55;151000000
133;150000000;Comedy Fantasy;Dark Shadows;50306728;245527149;1130;Dark Shadows;57;95527149
134;150000000;Action Adventure Thriller;Mission: Impossible - Rogue Nation;1,15E+16;682330139;1310;Mission: Impossible - Rogue Nation;71;532330139
135;150000000;Drama Horror Thriller;The Wolfman;21214571;0;1020;The Wolfman;55;-150000000
136;150000000;Family Animation Adventure Comedy;Bee Movie;29332905;287594577;910;Bee Movie;57;137594577
137;150000000;Animation Family;Kung Fu Panda 2;51247321;665692281;910;Kung Fu Panda 2;67;515692281
138;150000000;Action Adventure Family Fantasy;The Last Airbender;3,38E+16;318502923;1030;The Last Airbender;47;168502923
139;150000000;Adventure Action Thriller;Mission: Impossible III;63079003;397850012;1260;Mission: Impossible III;65;247850012
140;150000000;Action Drama Thriller;White House Down;39004588;205366737;1310;White House Down;64;55366737
141;150000000;Adventure Animation Family;Mars Needs Moms;1,24E+16;38992758;880;Mars Needs Moms;55;-111007242
142;149000000;Adventure Animation Comedy Family;Flushed Away;22550135;64459316;850;Flushed Away;60;-84540684
143;150000000;Adventure Family Fantasy;Pan;4803528;128388320;1110;Pan;59;-21611680
144;145000000;Animation Adventure Family;Mr. Peabody & Sherman;3873494;272912430;920;Mr. Peabody & Sherman;67;127912430
145;175000000;Adventure Drama War;Troy;66803149;497409852;1630;Troy;69;322409852
146;145000000;Animation Family;Madagascar 3: Europe's Most Wanted;4,50E+16;746921274;930;Madagascar 3: Europe's Most Wanted;64;601921274
147;140000000;Adventure Action Thriller;Die Another Day;5,42E+16;431971116;1330;Die Another Day;58;291971116
148;144000000;Action Fantasy Comedy;Ghostbusters;6621806;229147509;1160;Ghostbusters;53;85147509
149;140000000;Action Thriller Science Fiction Adventure;Armageddon;58485967;553799566;1510;Armageddon;64;413799566
150;140000000;Action Adventure Comedy Science Fiction;Men in Black II;91332849;441818803;880;Men in Black II;60;301818803
151;70000000;Adventure Action Animation;Beowulf;3,56E+15;195735876;1150;Beowulf;55;125735876
152;145000000;Action Adventure Animation Comedy Family;Kung Fu Panda 3;56747978;521170825;950;Kung Fu Panda 3;67;376170825
153;145000000;Action Thriller Adventure;Mission: Impossible - Ghost Protocol;7,78E+15;694713380;1330;Mission: Impossible - Ghost Protocol;68;549713380
154;145000000;Fantasy Animation Family;Rise of the Guardians;61788035;306941670;970;Rise of the Guardians;71;161941670
155;100000000;Comedy;Fun with Dick and Jane;2,52E+16;202026112;900;Fun with Dick and Jane;59;102026112
156;140000000;Drama Action War History;The Last Samurai;52341226;456758981;1540;The Last Samurai;73;316758981
157;140000000;Adventure Drama Action;Exodus: Gods and Kings;101599427;268031828;1500;Exodus: Gods and Kings;56;128031828
158;150000000;Science Fiction Action Adventure;Star Trek;7,36E+15;385680446;1270;Star Trek;74;235680446
159;139000000;Fantasy Action;Spider-Man;82502566;821708551;1210;Spider-Man;68;682708551
160;145000000;Fantasy Action Adventure Animation Comedy;How to Train Your Dragon 2;10021391;609123048;1020;How to Train Your Dragon 2;76;464123048
161;140000000;Fantasy;Gods of Egypt;56257249;150680864;1270;Gods of Egypt;53;10680864
162;135000000;Action;Stealth;1788953;76932943;1210;Stealth;49;-58067057
163;130000000;Action Mystery Science Fiction;Watchmen;64798873;185258983;1630;Watchmen;70;55258983
164;140000000;Action Adventure Comedy Crime Thriller;Lethal Weapon 4;24855701;285444603;1270;Lethal Weapon 4;63;145444603
165;137000000;Drama Action Science Fiction;Hulk;34981698;245360480;1380;Hulk;53;108360480
166;130000000;Adventure Action Science Fiction Thriller;G.I. Joe: Retaliation;59325589;371876278;1100;G.I. Joe: Retaliation;54;241876278
167;130000000;Action Adventure Comedy Drama Mystery;Sahara;2,16E+16;119269486;1240;Sahara;57;-10730514
168;137000000;Adventure Action Animation Fantasy Science Fiction;Final Fantasy: The Spirits Within;2,61E+16;85131830;1060;Final Fantasy: The Spirits Within;59;-51868170
169;140000000;Action Adventure Science Fiction;Captain America: The First Avenger;7,45E+15;370569774;1240;Captain America: The First Avenger;66;230569774
170;135000000;Adventure Action Thriller;The World Is Not Enough;39604363;361832400;1280;The World Is Not Enough;60;226832400
171;150000000;Adventure;Master and Commander: The Far Side of the World;36973031;212011111;1380;Master and Commander: The Far Side of the World;69;62011111
172;120000000;Adventure Fantasy Drama Romance;The Twilight Saga: Breaking Dawn - Part 2;99687084;829000000;1150;The Twilight Saga: Breaking Dawn - Part 2;61;709000000
173;130000000;Animation Comedy Family;Happy Feet Two;177735;150406466;1000;Happy Feet Two;58;20406466
174;150000000;Science Fiction Action Adventure;The Incredible Hulk;62898336;163712074;1140;The Incredible Hulk;61;13712074
175;140000000;Adventure Family Fantasy;The BFG;4419092;183345589;1200;The BFG;60;43345589
176;135000000;Western Drama Adventure Thriller;The Revenant;100635882;532950503;1560;The Revenant;73;397950503
177;135000000;Animation Family;Turbo;44765377;282570682;960;Turbo;61;147570682
178;135000000;Animation Comedy Family Western Adventure;Rango;2,99E+16;245724603;1070;Rango;66;110724603
179;132000000;Family Animation Adventure Comedy;Penguins of Madagascar;84366984;373552094;920;Penguins of Madagascar;65;241552094
180;70000000;Action Drama Mystery Thriller;The Bourne Ultimatum;45381501;442824138;1150;The Bourne Ultimatum;73;372824138
181;130000000;Adventure Animation Family Comedy;Kung Fu Panda;8,47E+15;631744560;900;Kung Fu Panda;69;501744560
182;130000000;Science Fiction Action Adventure;Ant-Man;1,20E+16;519311965;1170;Ant-Man;70;389311965
183;130000000;Adventure Action Science Fiction;The Hunger Games: Catching Fire;76310119;847423452;1460;The Hunger Games: Catching Fire;74;717423452
184;135000000;Fantasy Comedy Animation Science Fiction Family;Home;63473086;368871007;940;Home;68;233871007
185;132000000;Adventure Thriller Science Fiction;War of the Worlds;48572726;591739379;1160;War of the Worlds;62;459739379
186;130000000;Adventure Action Comedy Thriller Crime;Bad Boys II;38068736;273339556;1470;Bad Boys II;63;143339556
187;130000000;Action Adventure Animation Family Fantasy;Puss in Boots;20678787;554987477;900;Puss in Boots;64;424987477
188;110000000;Action Mystery Thriller;Salt;48829437;293329073;1000;Salt;62;183329073
189;125000000;Drama Adventure;Noah;46115758;362637473;1390;Noah;56;237637473
190;130000000;Adventure Animation Mystery;The Adventures of Tintin;89938296;371940071;1070;The Adventures of Tintin;67;241940071
191;130000000;Adventure Fantasy Family;Harry Potter and the Prisoner of Azkaban;79679601;789804554;1410;Harry Potter and the Prisoner of Azkaban;77;659804554
192;130000000;Drama;Australia;2,88E+16;49554002;1650;Australia;63;-80445998
193;130000000;Science Fiction Action Adventure;After Earth;42840582;243843127;1000;After Earth;50;113843127
194;127500000;Animation Family;Dinosaur;26548594;354248063;820;Dinosaur;62;226748063
195;127000000;Adventure Comedy Fantasy Family;Night at the Museum: Secret of the Tomb;115597753;349424282;970;Night at the Museum: Secret of the Tomb;61;222424282
196;130000000;Animation Action Comedy Family Science Fiction;Megamind;68757242;321887208;950;Megamind;67;191887208
197;125000000;Adventure Fantasy Family;Harry Potter and the Philosopher's Stone;109984351;976475550;1520;Harry Potter and the Philosopher's Stone;75;851475550
198;130000000;Fantasy Action Comedy Crime;R.I.P.D.;39448066;61648500;960;R.I.P.D.;54;-68351500
199;140000000;Adventure Fantasy Action;Pirates of the Caribbean: The Curse of the Black Pearl;271972889;655011224;1430;Pirates of the Caribbean: The Curse of the Black Pearl;75;515011224
200;125000000;Science Fiction Adventure Thriller;The Hunger Games: Mockingjay - Part 1;206227151;752100229;1230;The Hunger Games: Mockingjay - Part 1;66;627100229
201;125000000;Thriller Mystery;The Da Vinci Code;4,53E+16;767820459;1490;The Da Vinci Code;65;642820459
202;103000000;Animation Adventure Comedy Family;Rio 2;4,24E+16;500188435;1020;Rio 2;63;397188435
203;110000000;Adventure Action Science Fiction Thriller;X2;2871739;407711549;1330;X2;68;297711549
204;125000000;Action Thriller Crime;Fast Five;7,26E+15;626137675;1300;Fast Five;71;501137675
205;125000000;Adventure Action Crime Mystery;Sherlock Holmes: A Game of Shadows;8,15E+15;334615000;1290;Sherlock Holmes: A Game of Shadows;70;209615000
206;125000000;Adventure Fantasy Action;Clash of the Titans;47686442;232713139;1060;Clash of the Titans;56;107713139
207;65000000;Action Adventure Science Fiction;Total Recall;4,31E+16;261317921;1130;Total Recall;71;196317921
208;160000000;Adventure Fantasy Action;The 13th Warrior;27220157;61698899;1020;The 13th Warrior;64;-98301101
209;130000000;Action Thriller;The Bourne Legacy;9033681;276572938;1200;The Bourne Legacy;60;146572938
210;125000000;Action Crime Fantasy;Batman & Robin;50073575;238207122;1250;Batman & Robin;42;113207122
211;123000000;Family Comedy Fantasy;How the Grinch Stole Christmas;45419668;345141403;1040;How the Grinch Stole Christmas;62;222141403
212;125000000;Action Adventure Science Fiction Thriller;The Day After Tomorrow;41380094;544272402;1240;The Day After Tomorrow;62;419272402
213;125000000;Adventure Action Thriller;Mission: Impossible II;54931334;546388105;1230;Mission: Impossible II;59;421388105
214;120000000;Drama;The Perfect Storm;25752118;325756637;1300;The Perfect Storm;62;205756637
215;130000000;Adventure Fantasy Action Thriller;4: Rise of the Silver Surfer;6,08E+16;289047763;920;Fantastic 4: Rise of the Silver Surfer;54;159047763
216;120000000;Adventure Drama Action;Life of Pi;51328145;609016565;1270;Life of Pi;72;489016565
217;110000000;Thriller Action Fantasy Horror;Ghost Rider;4,68E+16;228738393;1140;Ghost Rider;52;118738393
218;120000000;Action Thriller;Jason Bourne;62641286;415484914;1230;Jason Bourne;59;295484914
219;120000000;Action Adventure Comedy;Charlie's Angels: Full Throttle;33616115;259175788;1060;Charlie's Angels: Full Throttle;52;139175788
220;130000000;Science Fiction Adventure Mystery;Prometheus;68889395;403170142;1240;Prometheus;63;273170142
221;120000000;Family Adventure Animation Comedy;Stuart Little 2;2,80E+15;169956806;780;Stuart Little 2;54;49956806
222;115000000;Science Fiction Action Drama Thriller;Elysium;6,73E+15;286140700;1090;Elysium;64;171140700
223;105000000;Action Science Fiction;The Chronicles of Riddick;2,78E+16;115772733;1190;The Chronicles of Riddick;63;10772733
224;120000000;Action Science Fiction;RoboCop;66757869;242688965;1020;RoboCop;57;122688965
225;120000000;Action Family Science Fiction;Speed Racer;1,71E+16;93945766;1350;Speed Racer;57;-26054234
226;120000000;Comedy Drama Romance;How Do You Know;11137655;48668907;1210;How Do You Know;49;-71331093
227;117000000;Action Comedy;Knight and Day;44906918;261930431;1090;Knight and Day;59;144930431
228;120000000;Action Science Fiction Adventure Mystery;Oblivion;67698004;286168572;1240;Oblivion;64;166168572
229;113000000;Science Fiction Adventure Action;Star Wars: Episode III - Revenge of the Sith;44108427;850000000;1400;Star Wars: Episode III - Revenge of the Sith;71;737000000
230;120000000;Adventure Action Science Fiction;Star Wars: Episode II - Attack of the Clones;43987061;649398328;1420;Star Wars: Episode II - Attack of the Clones;64;529398328
231;115000000;Animation Comedy Family;Monsters, Inc.;106815545;562816256;920;Monsters, Inc.;75;447816256
232;120000000;Action Science Fiction Adventure Fantasy;The Wolverine;1,60E+16;415440673;1260;The Wolverine;63;295440673
233;115000000;Adventure Action Science Fiction;Star Wars: Episode I - The Phantom Menace;54035265;924317558;1360;Star Wars: Episode I - The Phantom Menace;63;809317558
234;135000000;Adventure Animation Comedy Family Fantasy;The Croods;6,42E+15;585178928;980;The Croods;68;450178928
235;97250400;Fantasy Adventure Comedy Family;Astérix aux Jeux Olympiques;2,03E+16;132900000;1160;Asterix at the Olympic Games;50;35649600
236;115000000;Drama Action History War;Windtalkers;18714197;77628265;1340;Windtalkers;58;-37371735
237;115000000;Action Adventure Drama;The Huntsman: Winter's War;6,05E+16;164602163;1140;The Huntsman: Winter's War;60;49602163
238;125000000;Science Fiction Action Adventure Fantasy Comedy;Teenage Mutant Ninja Turtles;143350376;477200000;1010;Teenage Mutant Ninja Turtles;58;352200000
239;105000000;Science Fiction Thriller Drama;Gravity;110153618;716392705;910;Gravity;73;611392705
240;116000000;Action Adventure Thriller;Dante's Peak;1690444;178127760;1080;Dante's Peak;57;62127760
241;135000000;Fantasy Action Adventure Comedy;Teenage Mutant Ninja Turtles: Out of the Shadows;39873791;245623848;1120;Teenage Mutant Ninja Turtles: Out of the Shadows;58;110623848
242;120000000;Action Adventure Science Fiction;Fantastic Four;38126095;167977596;1000;Fantastic Four;44;47977596
243;110000000;Action Adventure Comedy Family Fantasy;Night at the Museum;48780039;574480841;1080;Night at the Museum;63;464480841
244;110000000;Action Drama Thriller;San Andreas;100412364;470490832;1140;San Andreas;60;360490832
245;110000000;Adventure Action Thriller;Tomorrow Never Dies;42887121;333011068;1190;Tomorrow Never Dies;60;223011068
246;110000000;Drama History War Action;The Patriot;23657284;215294342;1650;The Patriot;68;105294342
247;110000000;Thriller Crime;Ocean's Twelve;76840712;362744280;1250;Ocean's Twelve;64;252744280
248;110000000;Action Comedy Drama Thriller;Mr. & Mrs. Smith;44635452;478207520;1200;Mr. & Mrs. Smith;65;368207520
249;110000000;Adventure Science Fiction Thriller;Insurgent;1,04E+16;295238201;1190;Insurgent;62;185238201
250;116000000;Drama;The Aviator;45616098;102000000;1700;The Aviator;70;-14000000
251;112000000;Comedy;Gulliver's Travels;22845143;237382724;850;Gulliver's Travels;49;125382724
252;120000000;Action Crime Comedy;The Green Hornet;3,17E+15;227817248;1190;The Green Hornet;55;107817248
253;110000000;Action War;300: Rise of an Empire;7,15E+15;337580051;1020;300: Rise of an Empire;61;227580051
254;110000000;Animation Family Adventure Comedy Fantasy;The Smurfs;3665422;563749323;1030;The Smurfs;55;453749323
255;110000000;Animation Family;Home on the Range;19625972;103951461;760;Home on the Range;57;-6048539
256;110000000;Adventure Science Fiction;Allegiant;86105615;179246868;1210;Allegiant;59;69246868
257;110000000;Action Science Fiction Drama;Real Steel;3,72E+15;299268508;1270;Real Steel;66;189268508
258;105000000;Fantasy Family Comedy Animation;The Smurfs 2;3,25E+16;347434178;1050;The Smurfs 2;55;242434178
259;160000000;Action Adventure Thriller;Speed 2: Cruise Control;23336875;164508066;1210;Speed 2: Cruise Control;41;4508066
260;110000000;Science Fiction Action Adventure;Ender's Game;4594834;125537191;1140;Ender's Game;66;15537191
261;110000000;Action Thriller;Live Free or Die Hard;4,89E+16;383531464;1280;Live Free or Die Hard;64;273531464
262;93000000;Adventure Fantasy Action;The Lord of the Rings: The Fellowship of the Ring;138049577;871368364;1780;The Lord of the Rings: The Fellowship of the Ring;80;778368364
263;110000000;Action Adventure Comedy;Around the World in 80 Days;2,26E+15;72178895;1200;Around the World in 80 Days;57;-37821105
264;107000000;Drama;Ali;18866672;87713825;1570;Ali;67;-19286175
265;0;Comedy Fantasy Family;The Cat in the Hat;1,83E+16;0;820;The Cat in the Hat;49;0
266;120000000;Action Science Fiction;I, Robot;95914473;347234916;1150;I, Robot;67;227234916
267;130000000;Drama Action Adventure History War;Kingdom of Heaven;44490453;211643158;1440;Kingdom of Heaven;66;81643158
268;133000000;Animation Fantasy Family Comedy;Stuart Little;3,05E+16;300135367;840;Stuart Little;58;167135367
269;105000000;Romance Family Animation Music;The Princess and the Frog;62479574;267045765;970;The Princess and the Frog;67;162045765
270;108000000;Drama Adventure Science Fiction;The Martian;16793287;630161890;1410;The Martian;76;522161890
271;126000000;Action Thriller Science Fiction Adventure;The Island;3768056;162949164;1360;The Island;65;36949164
272;90000000;Comedy Romance;Town & Country;1004579;10372291;1040;Town & Country;37;-79627709
273;90000000;Action Crime Thriller;Gone in Sixty Seconds;52995628;237202299;1180;Gone in Sixty Seconds;61;147202299
274;103000000;Action Drama Adventure;Gladiator;95301296;457640427;1550;Gladiator;79;354640427
275;102000000;Action Thriller Science Fiction Mystery;Minority Report;65948959;358372926;1450;Minority Report;71;256372926
276;100000000;Adventure Fantasy Family;Harry Potter and the Chamber of Secrets;132397737;876688482;1610;Harry Potter and the Chamber of Secrets;74;776688482
277;150000000;Adventure Action Thriller;Casino Royale;88935165;599045960;1440;Casino Royale;73;449045960
278;100000000;Thriller Science Fiction Action Adventure;Planet of the Apes;51188633;362211740;1190;Planet of the Apes;56;262211740
279;100000000;Action Thriller Science Fiction;Terminator 2: Judgment Day;10174155;520000000;1370;Terminator 2: Judgment Day;77;420000000
280;80000000;History Crime Drama;Public Enemies;33691694;214104620;1400;Public Enemies;65;134104620
281;100000000;Drama Crime;American Gangster;42361215;266465037;1570;American Gangster;74;166465037
282;115000000;Action Thriller;True Lies;38729418;378882411;1410;True Lies;68;263882411
283;100000000;Thriller Drama Crime;The Taking of Pelham 1 2 3;40597856;150166126;1060;The Taking of Pelham 1 2 3;62;50166126
284;100000000;Comedy Romance;Little Fockers;32389353;310650585;980;Little Fockers;54;210650585
285;100000000;Action Comedy Crime;The Other Guys;24399642;170432927;1070;The Other Guys;61;70432927
286;100000000;Action Drama Mystery Thriller;Eraser;24507987;242295562;1150;Eraser;56;142295562
287;100000000;Drama Western;Django Unchained;82121691;425368238;1650;Django Unchained;78;325368238
288;100000000;Drama Animation Family;The Hunchback of Notre Dame;4,67E+16;100138851;910;The Hunchback of Notre Dame;68;138851
289;100000000;Adventure Animation Comedy Family Fantasy;The Emperor's New Groove;51113717;169327687;780;The Emperor's New Groove;72;69327687
290;100000000;Action Adventure Thriller;The Expendables 2;5,37E+15;312573423;1030;The Expendables 2;61;212573423
291;100000000;Adventure Action Thriller Mystery;National Treasure;5,88E+16;347451894;1310;National Treasure;64;247451894
292;100000000;Fantasy Action Adventure Family;Eragon;30863434;249288105;1040;Eragon;49;149288105
293;100000000;Family Fantasy;Where the Wild Things Are;3,16E+15;100086793;1010;Where the Wild Things Are;64;86793
294;100000000;Animation Adventure Family Fantasy;Epic;36711378;268426634;1020;Epic;64;168426634
295;100000000;Action Thriller Romance;The Tourist;41426678;278731369;1030;The Tourist;60;178731369
296;100000000;Action Fantasy Horror Mystery;End of Days;20652943;211989043;1210;End of Days;55;111989043
297;100000000;Drama Thriller Action;Blood Diamond;52792678;170877916;1430;Blood Diamond;73;70877916
298;100000000;Crime Drama Comedy;The Wolf of Wall Street;9,50E+15;392000694;1800;The Wolf of Wall Street;79;292000694
299;100000000;Action Crime Fantasy;Batman Forever;48205606;336529144;1210;Batman Forever;52;236529144
300;105000000;Adventure Action Thriller Science Fiction;Starship Troopers;58782359;121214377;1290;Starship Troopers;67;16214377
301;102000000;Drama Science Fiction;Cloud Atlas;73872343;130482868;1720;Cloud Atlas;66;28482868
302;80000000;Animation Adventure Family Fantasy;Legend of the Guardians: The Owls of Ga'Hoole;3,73E+16;140073390;970;Legend of the Guardians: The Owls of Ga'Hoole;65;60073390
303;100000000;Action Crime;Catwoman;32271938;82102379;1040;Catwoman;42;-17897621
304;100000000;Action Adventure;Hercules;76842247;243400000;990;Hercules;56;143400000
305;140000000;Adventure Animation Family Fantasy Science Fiction;Treasure Planet;38924136;109578115;950;Treasure Planet;72;-30421885
306;100000000;Adventure Comedy Science Fiction;Land of the Lost;1938841;68688831;1020;Land of the Lost;53;-31311169
307;90000000;Action Adventure Thriller;The Expendables 3;61025639;206172544;1270;The Expendables 3;61;116172544
308;105000000;Action Crime Thriller;Point Break;33507289;133718711;1140;Point Break;55;28718711
309;84000000;Fantasy Comedy Family Adventure;Son of the Mask;1,78E+16;0;940;Son of the Mask;36;-84000000
310;100000000;Thriller Drama Adventure Action History;In the Heart of the Sea;50767332;93820758;1220;In the Heart of the Sea;65;-6179242
311;100000000;Action Comedy Science Fiction;The Adventures of Pluto Nash;12092241;7103973;950;The Adventures of Pluto Nash;44;-92896027
312;100000000;War Action Adventure Drama Thriller;Green Zone;30254021;94882889;1150;Green Zone;64;-5117111
313;99000000;Animation;The Peanuts Movie;34308098;246233113;880;The Peanuts Movie;65;147233113
314;10000000;Crime Drama Mystery Thriller;The Spanish Prisoner;3091077;13835130;1100;The Spanish Prisoner;71;3835130
315;98000000;Adventure Action Fantasy;The Mummy Returns;41862983;433013274;1300;The Mummy Returns;60;335013274
316;100000000;Drama History Crime;Gangs of New York;4,62E+16;193772504;1670;Gangs of New York;71;93772504
317;94000000;Drama History War;金陵十三釵;12516546;95311434;1450;The Flowers of War;71;1311434
318;85000000;Animation Comedy Family;Surf's Up;23230851;149044513;850;Surf's Up;59;64044513
319;90000000;Action Comedy Science Fiction;The Stepford Wives;19224754;102000000;930;The Stepford Wives;54;12000000
320;92000000;Action History War;Black Hawk Down;44455166;172989651;1440;Black Hawk Down;72;80989651
321;0;Comedy;The Campaign;16460356;104907746;850;The Campaign;56;104907746
322;90000000;Adventure Fantasy Action Thriller Science Fiction;The Fifth Element;109528572;263920180;1260;The Fifth Element;73;173920180
323;100000000;Comedy Drama Romance;Sex and the City 2;18325897;288347692;1460;Sex and the City 2;54;188347692
324;95000000;Adventure Animation Comedy Family;The Road to El Dorado;3,71E+16;76432727;890;The Road to El Dorado;70;-18567273
325;95000000;Animation Comedy Adventure Family;Ice Age: Continental Drift;6,52E+15;877244782;880;Ice Age: Continental Drift;62;782244782
326;95000000;Romance Fantasy Family Drama;Cinderella;1,01E+16;543514353;1050;Cinderella;67;448514353
327;65000000;Fantasy Drama;The Lovely Bones;29257137;93525586;1360;The Lovely Bones;66;28525586
328;94000000;Animation Family;Finding Nemo;85688789;940335536;1000;Finding Nemo;76;846335536
329;94000000;Adventure Fantasy Action;The Lord of the Rings: The Return of the King;1,24E+16;1118888979;2010;The Lord of the Rings: The Return of the King;81;1024888979
330;79000000;Adventure Fantasy Action;The Lord of the Rings: The Two Towers;106914973;926287400;1790;The Lord of the Rings: The Two Towers;80;847287400
331;95000000;Adventure Fantasy;Seventh Son;63628459;114178613;1020;Seventh Son;52;19178613
332;115000000;Adventure Fantasy Action Thriller;Lara Croft: Tomb Raider;41498631;274703340;1000;Lara Croft: Tomb Raider;57;159703340
333;100000000;Thriller Science Fiction Drama Mystery;Transcendence;58991388;103039258;1190;Transcendence;59;3039258
334;93000000;Adventure Action Thriller Science Fiction;Jurassic Park III;1859364;368780809;920;Jurassic Park III;57;275780809
335;93000000;Thriller Action Drama Science Fiction;Rise of the Planet of the Apes;138433168;482860185;1050;Rise of the Planet of the Apes;70;389860185
336;90000000;Adventure Family Fantasy;The Spiderwick Chronicles;21436682;162839667;950;The Spiderwick Chronicles;63;72839667
337;92000000;Action Thriller;A Good Day to Die Hard;6,54E+15;304654182;980;A Good Day to Die Hard;52;212654182
338;145000000;Western History War;The Alamo;10660441;25819961;1370;The Alamo;58;-119180039
339;92000000;Action Adventure Animation Family;The Incredibles;77817571;631442092;1150;The Incredibles;74;539442092
340;98000000;Action Adventure;Cutthroat Island;7029308;10017322;1190;Cutthroat Island;57;-87982678
341;95000000;Adventure Fantasy Family;Percy Jackson & the Olympians: The Lightning Thief;6,11E+16;226497209;1180;Percy Jackson & the Olympians: The Lightning Thief;60;131497209
342;90000000;Action Adventure Comedy Science Fiction;Men in Black;104121555;589390539;980;Men in Black;69;499390539
343;90000000;Animation Comedy Family;Toy Story 2;73575118;497366869;920;Toy Story 2;73;407366869
344;100000000;Action Thriller;Unstoppable;37698465;167805466;980;Unstoppable;63;67805466
345;90000000;Action Comedy Crime Thriller;Rush Hour 2;35814765;347325802;900;Rush Hour 2;64;257325802
346;100000000;Drama Horror Mystery Thriller;What Lies Beneath;15835672;155464351;1300;What Lies Beneath;63;55464351
347;100000000;Animation Comedy Family;Cloudy with a Chance of Meatballs;46781182;242988466;900;Cloudy with a Chance of Meatballs;65;142988466
348;90000000;Animation Comedy Family Adventure;Ice Age: Dawn of the Dinosaurs;69457898;886686817;940;Ice Age: Dawn of the Dinosaurs;65;796686817
349;90000000;Adventure Comedy Drama Fantasy;The Secret Life of Walter Mitty;43348022;188133322;1140;The Secret Life of Walter Mitty;70;98133322
350;92000000;Action Adventure Comedy Crime Thriller;Charlie's Angels;4020395;264105545;980;Charlie's Angels;56;172105545
351;90000000;Drama Thriller Crime;The Departed;63429157;289847354;1510;The Departed;79;199847354
352;90000000;Animation Family Adventure;Mulan;67427755;304320254;880;Mulan;76;214320254
353;92000000;Action Comedy;Tropic Thunder;43192048;188072649;1070;Tropic Thunder;65;96072649
354;90000000;Thriller Crime Mystery Drama;The Girl with the Dragon Tattoo;47651083;232617430;1580;The Girl with the Dragon Tattoo;72;142617430
355;90000000;Action Thriller;Die Hard: With a Vengeance;5,19E+15;366101666;1280;Die Hard: With a Vengeance;69;276101666
356;90000000;Action Adventure Crime Mystery;Sherlock Holmes;57834787;524028679;1280;Sherlock Holmes;70;434028679
357;100000000;Drama;Ben-Hur;2,96E+16;94061311;1250;Ben-Hur;53;-5938689
358;120000000;Animation Family Adventure Science Fiction;Atlantis: The Lost Empire;51548589;186053725;950;Atlantis: The Lost Empire;67;66053725
359;0;Adventure Animation Comedy Family;Alvin and the Chipmunks: The Road Chip;27867368;233755553;920;Alvin and the Chipmunks: The Road Chip;58;233755553
360;75000000;Drama Thriller History War;Valkyrie;38832842;200276000;1210;Valkyrie;67;125276000
361;90000000;Comedy Action;You Don't Mess with the Zohan;40597344;201596308;1130;You Don't Mess with the Zohan;55;111596308
362;88000000;Action Comedy Science Fiction;Pixels;140849495;243637091;1050;Pixels;56;155637091
363;100000000;Drama Science Fiction Adventure;A.I. Artificial Intelligence;34035114;235926552;1460;A.I. Artificial Intelligence;68;135926552
364;90000000;Thriller Fantasy Comedy Family Mystery;The Haunted Mansion;16302378;182290266;990;The Haunted Mansion;52;92290266
365;90000000;Drama Science Fiction Mystery;Contact;5,52E+16;171120329;1500;Contact;72;81120329
366;95000000;Action Science Fiction Thriller;Hollow Man;28200874;190213455;1120;Hollow Man;56;95213455
367;80000000;Crime Thriller;The Interpreter;1869984;162944923;1280;The Interpreter;62;82944923
368;90000000;Adventure Family Fantasy;Percy Jackson: Sea of Monsters;4,03E+16;174578751;1060;Percy Jackson: Sea of Monsters;59;84578751
369;95000000;Action Adventure Fantasy Thriller;Lara Croft Tomb Raider: The Cradle of Life;5,68E+15;156505388;1170;Lara Croft Tomb Raider: The Cradle of Life;55;61505388
370;90000000;Action Adventure Comedy Crime Mystery;Now You See Me 2;51535701;334901337;1290;Now You See Me 2;67;244901337
371;68000000;Thriller Action Romance Science Fiction Adventure;The Saint;20913852;118063304;1160;The Saint;59;50063304
372;92000000;Action Crime Thriller;Spy Game;27166757;143049560;1260;Spy Game;68;51049560
373;90000000;Science Fiction;Mission to Mars;16058284;60874615;1140;Mission to Mars;57;-29125385
374;90000000;Animation Adventure Comedy Family;Rio;4,62E+16;484635760;960;Rio;65;394635760
375;100000000;Comedy Science Fiction;Bicentennial Man;24939295;93700000;1310;Bicentennial Man;69;-6300000
376;90000000;Science Fiction Action Drama Thriller;Volcano;1,98E+16;0;1040;Volcano;52;-90000000
377;90000000;Crime Thriller Drama;The Devil's Own;1,54E+16;140807547;1070;The Devil's Own;59;50807547
378;100000000;Drama History Thriller;K-19: The Widowmaker;1,56E+16;35168966;1380;K-19: The Widowmaker;61;-64831034
379;20000000;Adventure Fantasy Action;Conan the Barbarian;31802807;79114085;1290;Conan the Barbarian;66;59114085
380;88000000;Romance Drama History;Cinderella Man;24100863;108539911;1440;Cinderella Man;73;20539911
381;90000000;Fantasy Action Family;The Nutcracker: The Untold Story;3593349;16178959;1100;The Nutcracker: The Untold Story;54;-73821041
382;87000000;Drama History;Seabiscuit;14824166;148336445;1410;Seabiscuit;67;61336445
383;92000000;Action Adventure Drama;Twister;3,21E+16;494471524;1130;Twister;61;402471524
384;90000000;Adventure Drama;Cast Away;57739713;429632142;1430;Cast Away;75;339632142
385;100000000;Animation Comedy;Happy Feet;37272385;384335608;1080;Happy Feet;59;284335608
386;75000000;Action Drama Thriller;The Bourne Supremacy;53213931;288500217;1080;The Bourne Supremacy;72;213500217
387;85000000;Action Thriller;Air Force One;3638795;315156409;1240;Air Force One;62;230156409
388;85000000;Thriller Crime;Ocean's Eleven;60929352;450717150;1160;Ocean's Eleven;72;365717150
389;75000000;Adventure Action Thriller;The Three Musketeers;36605246;132274484;1100;The Three Musketeers;56;57274484
390;85000000;Animation Comedy Family Fantasy;Hotel Transylvania;56257411;358375603;910;Hotel Transylvania;68;273375603
391;85000000;Comedy Family Fantasy Romance;Enchanted;2921998;340487652;1070;Enchanted;66;255487652
392;85000000;Action Thriller;Safe House;34773106;208076205;1150;Safe House;63;123076205
393;85000000;Comedy Family;102 Dalmatians;9895061;183611771;1000;102 Dalmatians;51;98611771
394;75000000;Action Comedy;Tower Heist;36743324;152930623;1040;Tower Heist;58;77930623
395;85000000;Comedy Romance;The Holiday;4,50E+16;194168700;1360;The Holiday;67;109168700
396;90000000;Action Drama Thriller;Enemy of the State;41207568;250649836;1320;Enemy of the State;67;160649836
397;85000000;Comedy Romance;It's Complicated;16479851;219103655;1210;It's Complicated;62;134103655
398;85000000;Crime Thriller;Ocean's Thirteen;42069993;311312624;1220;Ocean's Thirteen;65;226312624
399;85000000;Adventure Animation Family;Open Season;2661951;197309027;830;Open Season;61;112309027
400;85000000;Adventure Action Science Fiction;Divergent;80316463;288747895;1390;Divergent;69;203747895
401;68000000;War;Enemy at the Gates;41273567;96976270;1310;Enemy at the Gates;72;28976270
402;85000000;Adventure Action Comedy Thriller;The Rundown;24107835;80916492;1040;The Rundown;64;-4083508
403;85000000;Adventure Fantasy Action Comedy Family;Last Action Hero;32044191;137298489;1300;Last Action Hero;61;52298489
404;85000000;Drama History Romance;Memoirs of a Geisha;16595874;162242962;1450;Memoirs of a Geisha;73;77242962
405;85000000;Action Crime Drama Thriller;The Fast and the Furious: Tokyo Drift;8282876;158468292;1040;The Fast and the Furious: Tokyo Drift;61;73468292
406;0;Drama Animation Family Comedy;Arthur Christmas;1983683;0;970;Arthur Christmas;67;0
407;90000000;Fantasy Drama Mystery;Meet Joe Black;36069611;142940100;1780;Meet Joe Black;69;52940100
408;85000000;Action Thriller Drama;Collateral Damage;18827753;78382433;1080;Collateral Damage;55;-6617567
409;0;Drama Music;All That Jazz;5159407;37823676;1230;All That Jazz;73;37823676
410;85000000;Adventure Fantasy Drama Comedy Science Fiction;Mirror Mirror;4,81E+16;183018522;1060;Mirror Mirror;55;98018522
411;60000000;Action Adventure Comedy;Scott Pilgrim vs. the World;38885195;47664559;1120;Scott Pilgrim vs. the World;72;-12335441
412;60000000;Action Thriller Adventure Science Fiction;The Core;2,92E+16;74208267;1360;The Core;54;14208267
413;84000000;Fantasy Comedy Romance Science Fiction;Nutty Professor II: The Klumps;17783361;123307945;1060;Nutty Professor II: The Klumps;47;39307945
414;84000000;Mystery Adventure Comedy;Scooby-Doo;3,14E+16;275650703;880;Scooby-Doo;54;191650703
415;50000000;Action Science Fiction;Dredd;5,77E+15;41037742;950;Dredd;66;-8962258
416;82500000;Comedy Drama Fantasy Romance;Click;41176631;237681299;1070;Click;60;155181299
417;8000000;Horror Comedy Fantasy;Creepshow;1,37E+16;21028755;1200;Creepshow;67;13028755
418;85000000;Comedy Family;Cats & Dogs 2 : The Revenge of Kitty Galore;1177398;112483764;820;Cats & Dogs 2 : The Revenge of Kitty Galore;49;27483764
419;85000000;Adventure Fantasy Science Fiction;Jumper;2,12E+16;222231186;880;Jumper;59;137231186
420;85000000;Adventure Fantasy Science Fiction;Hellboy II: The Golden Army;5857976;160388063;1200;Hellboy II: The Golden Army;65;75388063
421;65000000;Crime Drama Mystery Thriller;Zodiac;51970905;84785914;1570;Zodiac;73;19785914
422;82000000;Science Fiction;The 6th Day;18447479;96085477;1230;The 6th Day;57;14085477
423;80000000;Fantasy Comedy;Bruce Almighty;1,10E+16;484572835;1010;Bruce Almighty;64;404572835
424;80000000;Thriller Adventure Action;The Expendables;7,76E+15;274470394;1030;The Expendables;60;194470394
425;80000000;Adventure Action Thriller;Mission: Impossible;75290998;457696359;1100;Mission: Impossible;67;377696359
426;75000000;Science Fiction Adventure Fantasy;The Hunger Games;68550698;691210692;1420;The Hunger Games;69;616210692
427;80000000;Comedy;The Hangover Part II;58040149;254455986;1020;The Hangover Part II;62;174455986
428;80000000;Action Fantasy;Batman Returns;59113174;280000000;1260;Batman Returns;66;200000000
429;80000000;Comedy Animation Family;Over the Hedge;3632705;343397247;830;Over the Hedge;63;263397247
430;80000000;Animation Family;Lilo & Stitch;55659988;145771527;850;Lilo & Stitch;71;65771527
431;85000000;Comedy Family Fantasy;Charlotte's Web;1,41E+16;144000000;970;Charlotte's Web;58;59000000
432;75000000;Action Drama Romance;Deep Impact;34070054;140464664;1200;Deep Impact;59;65464664
433;84000000;Action Comedy Crime Thriller;RED 2;4434333;0;1160;RED 2;64;-84000000
434;82000000;Comedy Drama;The Longest Yard;26065735;190320568;1130;The Longest Yard;62;108320568
435;75000000;Comedy Fantasy Family Music Animation;Alvin and the Chipmunks: Chipwrecked;23473004;342695435;870;Alvin and the Chipmunks: Chipwrecked;54;267695435
436;80000000;Comedy;Grown Ups 2;45589568;246984278;1000;Grown Ups 2;58;166984278
437;80000000;Action Comedy Thriller;Get Smart;23496054;230685453;1100;Get Smart;60;150685453
438;80000000;Drama Comedy Romance;Something's Gotta Give;16939441;266728738;1280;Something's Gotta Give;63;186728738
439;80000000;Drama Thriller Mystery;Shutter Island;8,19E+15;294804195;1380;Shutter Island;78;214804195
440;80000000;Comedy Romance Drama;Four Christmases;1,95E+16;163733697;880;Four Christmases;53;83733697
441;75000000;Animation Comedy Family Science Fiction;Robots;29558157;260696994;910;Robots;60;185696994
442;80000000;Action Crime Science Fiction Thriller;Face/Off;46075037;245676146;1380;Face/Off;68;165676146
443;80000000;Fantasy Comedy Family Romance;Bedtime Stories;2,35E+16;212874442;990;Bedtime Stories;59;132874442
444;80000000;Thriller Crime Drama;Road to Perdition;49078546;181001478;1170;Road to Perdition;73;101001478
445;80000000;Romance Comedy;Just Go with It;3702665;214918407;1170;Just Go with It;63;134918407
446;75000000;Action Thriller Crime;Con Air;45154631;224012234;1150;Con Air;65;149012234
447;80000000;Mystery Thriller Action;Eagle Eye;46887983;178066569;1180;Eagle Eye;63;98066569
448;79000000;Drama;Cold Mountain;24598479;173013509;1540;Cold Mountain;67;94013509
449;80000000;Action Thriller Science Fiction;The Book of Eli;32363538;157107755;1180;The Book of Eli;66;77107755
450;80000000;Comedy Family Science Fiction;Flubber;1,15E+16;177977226;930;Flubber;53;97977226
451;80000000;Horror Thriller Fantasy Mystery;The Haunting;19375768;91188905;1130;The Haunting;52;11188905
452;80000000;Animation Comedy Drama Family Fantasy;Space Jam;36125715;250200000;880;Space Jam;65;170200000
453;0;Action Comedy Crime Mystery Family;The Pink Panther;25450534;0;930;The Pink Panther;56;0
454;80000000;Drama Science Fiction Thriller;The Day the Earth Stood Still;41890722;233093859;1040;The Day the Earth Stood Still;52;153093859
455;75000000;Action Drama Mystery Thriller;Conspiracy Theory;22179658;136982834;1350;Conspiracy Theory;65;61982834
456;68000000;War Drama Action;Fury;139575085;211817906;1350;Fury;74;143817906
457;70000000;Action Adventure Comedy Romance;Six Days Seven Nights;1,83E+16;164000000;980;Six Days Seven Nights;56;94000000
458;80000000;Comedy Family Animation Adventure;Yogi Bear;11187696;201584141;800;Yogi Bear;52;121584141
459;80000000;Western Animation Adventure Comedy Family;Spirit: Stallion of the Cimarron;41670544;122563539;830;Spirit: Stallion of the Cimarron;74;42563539
460;80000000;Comedy Romance Family;Zookeeper;2,75E+16;169852759;1020;Zookeeper;53;89852759
461;80000000;Adventure Family Science Fiction;Lost in Space;1,75E+16;136159423;1300;Lost in Space;50;56159423
462;80000000;Drama Thriller Mystery;The Manchurian Candidate;21394281;96105964;1290;The Manchurian Candidate;62;16105964
463;0;Romance Drama;Déjà Vu;605645;0;1170;Déjà Vu;80;0
464;80000000;Animation Comedy Family;Hotel Transylvania 2;61692197;473226958;890;Hotel Transylvania 2;67;393226958
465;80000000;Animation Family Music;Fantasia 2000;1,45E+16;90874570;740;Fantasia 2000;70;10874570
466;80000000;Science Fiction Adventure Action;The Time Machine;25978555;123729176;960;The Time Machine;58;43729176
467;90000000;Action Adventure Family Fantasy;Mighty Joe Young;6643778;0;1140;Mighty Joe Young;59;-90000000
468;102000000;Action Crime Thriller;Swordfish;36788745;147080413;990;Swordfish;61;45080413
469;75000000;Action Adventure;The Legend of Zorro;3,11E+16;142400065;1290;The Legend of Zorro;59;67400065
470;85000000;Drama Fantasy Romance;What Dreams May Come;21891078;71485043;1130;What Dreams May Come;68;-13514957
471;85000000;Comedy Fantasy Romance;Little Nicky;18335992;0;900;Little Nicky;52;-85000000
472;88000000;Adventure Fantasy Action Comedy Thriller;The Brothers Grimm;4,01E+16;105316267;1180;The Brothers Grimm;56;17316267
473;70000000;Comedy Fantasy Science Fiction;Mars Attacks!;4,41E+16;101371017;1060;Mars Attacks!;61;31371017
474;0;Mystery Drama Horror;Évolution;3300061;0;810;Evolution;64;0
475;0;Action Adventure Drama;The Edge;20632673;43312294;1170;The Edge;67;43312294
476;80000000;Action Science Fiction Thriller;Surrogates;36664991;122444772;890;Surrogates;59;42444772
477;80000000;Drama Thriller;Thirteen Days;1,83E+16;34566746;1450;Thirteen Days;69;-45433254
478;80000000;Action Adventure Thriller;Daylight;16681269;159212469;1150;Daylight;58;79212469
479;80000000;Animation Family Adventure;Walking With Dinosaurs;10088006;126546518;870;Walking With Dinosaurs;52;46546518
480;44000000;Action Science Fiction War;Battlefield Earth;789147;21400000;1180;Battlefield Earth;30;-22600000
481;80000000;Animation Comedy Family;Looney Tunes: Back in Action;16715631;68514844;900;Looney Tunes: Back in Action;56;-11485156
482;80000000;Drama Music Romance;Nine;9,36E+15;53825515;1120;Nine;51;-26174485
483;80000000;Action Adventure Science Fiction;Timeline;1122268;19480739;1160;Timeline;54;-60519261
484;80000000;Drama Adventure;The Postman;1,46E+16;17626234;1770;The Postman;61;-62373766
485;90000000;Adventure Comedy Drama Family Fantasy;Babe: Pig in the City;11356079;69131860;920;Babe: Pig in the City;52;-20868140
486;90000000;Fantasy Action Adventure;The Last Witch Hunter;52612025;146936910;1060;The Last Witch Hunter;57;56936910
487;80000000;Thriller Action Science Fiction;Red Planet;13800656;33463969;1060;Red Planet;54;-46536031
488;86000000;Adventure Fantasy Animation Family;Arthur et les Minimoys;27097932;107944236;940;Arthur and the Invisibles;60;21944236
489;0;Documentary Family;Oceans;10706613;19406406;840;Oceans;73;19406406
490;80000000;Thriller Science Fiction Adventure Action;A Sound of Thunder;7342892;5989640;1100;A Sound of Thunder;48;-74010360
491;130000000;Action Adventure History Romance Drama;Pompeii;50561849;117831631;1050;Pompeii;52;-12168369
492;8000000;Comedy Animation;Don Gato: El inicio de la pandilla;719996;0;890;Top Cat Begins;53;-8000000
493;60000000;Drama Romance;A Beautiful Mind;59248437;313542341;1350;A Beautiful Mind;77;253542341
494;45000000;Family Animation Drama;The Lion King;90457886;788241776;890;The Lion King;80;743241776
495;79000000;Adventure Action Science Fiction;Journey 2: The Mysterious Island;4,07E+15;355692760;940;Journey 2: The Mysterious Island;58;276692760
496;78000000;Animation Family Comedy;Cloudy with a Chance of Meatballs 2;41247402;248384621;950;Cloudy with a Chance of Meatballs 2;64;170384621
497;78000000;Crime Thriller Horror;Red Dragon;10083905;209196298;1240;Red Dragon;67;131196298
498;100000000;Western Adventure;Hidalgo;16759252;108103450;1360;Hidalgo;65;8103450
499;79000000;Comedy;Jack and Jill;2,21E+16;149673788;910;Jack and Jill;41;70673788
500;76000000;Action Crime Thriller;2 Fast 2 Furious;10520961;236350661;1070;2 Fast 2 Furious;62;160350661
501;64000000;Adventure Animation Fantasy;The Little Prince;35384423;97571250;920;The Little Prince;76;33571250
502;80000000;Science Fiction Thriller;The Invasion;15673154;15071514;990;The Invasion;57;-64928486
503;76000000;Action Adventure Animation Comedy Family;The Adventures of Rocky & Bullwinkle;8981427;35134820;880;The Adventures of Rocky & Bullwinkle;39;-40865180
504;75000000;Animation Family;The Secret Life of Pets;3,15E+16;875958308;870;The Secret Life of Pets;59;800958308
505;78000000;Fantasy Action Thriller Science Fiction;The League of Extraordinary Gentlemen;47436675;179265204;1100;The League of Extraordinary Gentlemen;57;101265204
506;76000000;Animation Comedy Family;Despicable Me 2;136886704;970761885;980;Despicable Me 2;70;894761885
507;75000000;Action Adventure Science Fiction;Independence Day;60442593;816969268;1450;Independence Day;67;741969268
508;73000000;Adventure Action Science Fiction;The Lost World: Jurassic Park;2502487;229074524;1290;The Lost World: Jurassic Park;62;156074524
509;75000000;Family Animation;Madagascar;48110909;532680671;860;Madagascar;66;457680671
510;76000000;Drama Action Thriller Science Fiction;Children of Men;35387874;69959751;1090;Children of Men;74;-6040249
511;75000000;Adventure Action Science Fiction;X-Men;4,67E+16;296339527;1040;X-Men;68;221339527
512;75000000;Action Thriller Crime;Wanted;7382289;258270008;1100;Wanted;64;183270008
513;75000000;Action Adventure Thriller;The Rock;51469576;335062621;1360;The Rock;69;260062621
514;80000000;Animation Family Comedy Adventure;Ice Age: The Meltdown;8,51E+15;660940780;910;Ice Age: The Meltdown;65;580940780
515;75000000;Comedy Romance;50 First Dates;6,14E+16;196482882;990;50 First Dates;66;121482882
516;50000000;Family Comedy Music Romance;Hairspray;31160542;90450008;1170;Hairspray;65;40450008
517;80000000;Horror Mystery Thriller;Exorcist: The Beginning;15761384;78000586;1140;Exorcist: The Beginning;47;-1999414
518;75000000;Action Adventure Comedy Family;Inspector Gadget;1,76E+16;0;780;Inspector Gadget;43;-75000000
519;75000000;Thriller Crime;Now You See Me;71124686;117698894;1150;Now You See Me;73;42698894
520;80000000;Comedy;Grown Ups;38864027;271430189;1020;Grown Ups;60;191430189
521;60000000;Comedy Drama;The Terminal;57753914;219417255;1280;The Terminal;70;159417255
522;35000000;Comedy Family;Hotel for Dogs;1325753;73034460;1000;Hotel for Dogs;57;38034460
523;75000000;Action Adventure Thriller;Vertical Limit;13318744;215663859;1240;Vertical Limit;59;140663859
524;75000000;Comedy Drama History;Charlie Wilson's War;1870031;119000410;1020;Charlie Wilson's War;65;44000410
525;75000000;Animation Action Comedy Family;Shark Tale;47094369;367275019;900;Shark Tale;58;292275019
526;70000000;Drama;Dreamgirls;1,45E+16;154937680;1340;Dreamgirls;66;84937680
527;53000000;Comedy Crime;Be Cool;1,86E+16;95226116;1180;Be Cool;54;42226116
528;70000000;Drama Action History Thriller;Munich;2,90E+16;130358911;1640;Munich;69;60358911
529;70000000;Action Drama War;Tears of the Sun;27055085;85632458;1210;Tears of the Sun;64;15632458
530;75000000;Action Comedy Thriller Romance;Killers;23004607;98159963;1000;Killers;57;23159963
531;75000000;Comedy Action Adventure;The Man from U.N.C.L.E.;4,87E+15;108145109;1160;The Man from U.N.C.L.E.;71;33145109
532;80000000;Comedy;Spanglish;14209329;55041367;1300;Spanglish;58;-24958633
533;75000000;Animation Comedy Family Fantasy;Monster House;36368839;140175006;910;Monster House;63;65175006
534;75000000;Action Comedy Crime Romance;Bandits;24353302;67631903;1230;Bandits;62;-7368097
535;55000000;Action Adventure Drama Romance;First Knight;19143321;127600435;1340;First Knight;59;72600435
536;75000000;Drama History Romance;Anna and the King;13327372;0;1480;Anna and the King;64;-75000000
537;75000000;Fantasy Action Drama;Immortals;3,79E+16;226904017;1100;Immortals;57;151904017
538;52000000;Mystery Drama Thriller Crime;Hostage;23663713;77944725;1130;Hostage;62;25944725
539;75000000;Animation Action Science Fiction Family Adventure;Titan A.E.;1,44E+16;36754634;940;Titan A.E.;63;-38245366
540;75000000;Action Adventure Comedy Thriller;Hollywood Homicide;10605084;51142659;1160;Hollywood Homicide;50;-23857341
541;75000000;Action War Science Fiction;Soldier;11873856;14567883;990;Soldier;61;-60432117
542;0;Action Drama Horror Science Fiction Thriller;Carriers;12708963;5802422;840;Carriers;58;5802422
543;75000000;Adventure Fantasy Animation Action Comedy;Monkeybone;8098369;5409517;930;Monkeybone;43;-69590483
544;45000000;Action Adventure Drama Thriller;Flight of the Phoenix;20374308;21009180;1130;Flight of the Phoenix;57;-23990820
545;75000000;Science Fiction Thriller Drama;Unbreakable;42006908;248118121;1060;Unbreakable;69;173118121
546;74000000;Family Animation Adventure Comedy;Minions;875581305;1156730962;910;Minions;64;1082730962
547;82000000;Action Fantasy Thriller;Sucker Punch;39127082;89792502;1100;Sucker Punch;59;7792502
548;73000000;Crime Mystery;Snake Eyes;20790703;103891409;980;Snake Eyes;58;30891409
549;75000000;Science Fiction;Sphere;1,87E+16;13100000;1340;Sphere;58;-61900000
550;73000000;Family Animation;The Angry Birds Movie;45720894;349779543;970;The Angry Birds Movie;59;276779543
551;70000000;Romance Comedy Adventure;Fool's Gold;2,18E+16;111231041;1120;Fool's Gold;54;41231041
552;75000000;Comedy Drama;Funny People;20199057;61458982;1460;Funny People;57;-13541018
553;70000000;Thriller Action Drama;The Kingdom;2,61E+16;86658558;1100;The Kingdom;65;16658558
554;72500000;Comedy;Talladega Nights: The Ballad of Ricky Bobby;12599836;162966177;1160;Talladega Nights: The Ballad of Ricky Bobby;62;90466177
555;70000000;Comedy Family Romance Fantasy;Dr. Dolittle 2;13543053;176104344;870;Dr. Dolittle 2;49;106104344
556;72000000;Action Drama History War;Braveheart;60722162;210000000;1770;Braveheart;77;138000000
557;72000000;Drama War;Jarhead;3,22E+16;96889998;1250;Jarhead;66;24889998
558;75000000;Animation Comedy Family;The Simpsons Movie;46875375;527068851;870;The Simpsons Movie;69;452068851
559;72000000;Drama Romance;The Majestic;11215702;37317558;1520;The Majestic;66;-34682442
560;94000000;Action;Driven;8468586;54744738;1160;Driven;45;-39255262
561;74500000;Adventure Drama Family;Deux frères;8,88E+15;62172050;1090;Two Brothers;69;-12327950
562;60000000;Drama Mystery Thriller;The Village;27491891;256697520;1080;The Village;62;196697520
563;71000000;Comedy Family Fantasy;Doctor Dolittle;21462935;294456605;850;Doctor Dolittle;54;223456605
564;72000000;Drama Thriller Science Fiction Mystery;Signs;28848187;408247917;1060;Signs;64;336247917
565;150000000;Adventure Animation Comedy Family Fantasy;Shrek 2;47320801;919838758;930;Shrek 2;67;769838758
566;120000000;Animation Adventure Comedy Family;Cars;82643036;461983149;1170;Cars;66;341983149
567;70000000;Comedy Romance;Runaway Bride;20230535;309457509;1160;Runaway Bride;57;239457509
568;70000000;Action Adventure Thriller;xXx;46217769;277448382;1240;xXx;58;207448382
569;74000000;Animation Adventure Comedy Family;The SpongeBob Movie: Sponge Out of Water;36952268;311594032;930;The SpongeBob Movie: Sponge Out of Water;58;237594032
570;80000000;Action Thriller;Ransom;16411345;309492681;1170;Ransom;64;229492681
571;70000000;Drama Action Thriller War;Inglourious Basterds;72595961;319131050;1530;Inglourious Basterds;79;249131050
572;70000000;Adventure Fantasy Comedy Family;Hook;33648404;300854823;1440;Hook;66;230854823
573;70000000;Action Thriller;Die Hard 2;5,77E+15;240031094;1240;Die Hard 2;66;170031094
574;80000000;Action Thriller Crime;S.W.A.T.;34052253;116643346;1170;S.W.A.T.;58;36643346
575;68000000;Drama Mystery Romance Science Fiction Thriller;Vanilla Sky;27299301;203388341;1360;Vanilla Sky;65;135388341
576;75000000;Drama Thriller Fantasy Mystery;Lady in the Water;20219385;42285169;1100;Lady in the Water;53;-32714831
577;70000000;Adventure Science Fiction Action;AVP: Alien vs. Predator;4,30E+16;171183863;1010;AVP: Alien vs. Predator;55;101183863
578;75000000;Comedy Family Animation Fantasy Music;Alvin and the Chipmunks: The Squeakquel;29412262;443140005;880;Alvin and the Chipmunks: The Squeakquel;54;368140005
579;75000000;Action History War;We Were Soldiers;19708731;114660784;1380;We Were Soldiers;67;39660784
580;70000000;Action Thriller;Olympus Has Fallen;5,94E+16;161025640;1200;Olympus Has Fallen;62;91025640
581;70000000;Science Fiction Action Adventure Thriller;Star Trek: Insurrection;1,97E+16;118000000;1030;Star Trek: Insurrection;63;48000000
582;70000000;Action Science Fiction;Battle: Los Angeles;4,92E+16;202466756;1160;Battle: Los Angeles;55;132466756
583;70000000;Adventure Fantasy Drama;Big Fish;46199482;122919055;1250;Big Fish;76;52919055
584;0;Fantasy;Wolf;1,38E+16;0;1250;Wolf;60;0
585;66000000;Drama War;War Horse;29505574;177584879;1460;War Horse;70;111584879
586;70000000;War Drama History Action;The Monuments Men;43873266;154984035;1180;The Monuments Men;58;84984035
587;70000000;Adventure Action Thriller Science Fiction;The Abyss;24961625;90000098;1390;The Abyss;71;20000098
588;70000000;Drama Crime;Wall Street: Money Never Sleeps;2325645;134748021;1330;Wall Street: Money Never Sleeps;58;64748021
589;70000000;Horror Action Drama Fantasy War;Dracula Untold;6,45E+15;215529201;920;Dracula Untold;62;145529201
590;70000000;Drama Action Thriller Crime;The Siege;20089933;116672912;1160;The Siege;60;46672912
591;70000000;Adventure Fantasy Romance Family;Stardust;4,80E+15;135560026;1270;Stardust;71;65560026
592;70000000;Adventure Drama History;Seven Years in Tibet;1692991;131457682;1360;Seven Years in Tibet;70;61457682
593;70000000;Comedy Drama;The Dilemma;14780634;67112664;1110;The Dilemma;52;-2887336
594;70000000;Action Adventure Comedy Thriller;Bad Company;1,41E+16;65977295;1160;Bad Company;54;-4022705
595;60000000;Adventure Action Horror;Doom;2,93E+16;55987321;1050;Doom;50;-4012679
596;70000000;Action Adventure Comedy Thriller;I Spy;13267631;33561137;970;I Spy;52;-36438863
597;70000000;Fantasy Action Horror;Underworld: Awakening;5,84E+15;160112671;880;Underworld: Awakening;61;90112671
598;75000000;Comedy Drama Music Romance;Rock of Ages;2,35E+16;59418613;1230;Rock of Ages;60;-15581387
599;70000000;Drama War;Hart's War;14244518;32287044;1250;Hart's War;59;-37712956
600;66000000;Action Adventure Thriller;Killer Elite;2,95E+15;57777106;1160;Killer Elite;61;-8222894
601;0;Action Science Fiction Thriller;Rollerball;9306253;0;980;Rollerball;34;0
602;70000000;Action Adventure Thriller;Ballistic: Ecks vs. Sever;837378;19924033;910;Ballistic: Ecks vs. Sever;43;-50075967
603;70000000;Thriller;Hard Rain;10930537;19870567;970;Hard Rain;55;-50129433
604;75000000;Adventure Animation Action Comedy Family;Osmosis Jones;1054544;13596911;950;Osmosis Jones;59;-61403089
605;70000000;Animation Music Family;Legends of Oz: Dorothy's Return;6,68E+16;18662027;880;Legends of Oz: Dorothy's Return;59;-51337973
606;70000000;Crime Drama Mystery;Blackhat;46832372;17752940;1330;Blackhat;51;-52247060
607;70000000;Mystery Action Thriller Science Fiction Adventure;Sky Captain and the World of Tomorrow;24664776;57958696;1070;Sky Captain and the World of Tomorrow;57;-12041304
608;70000000;Crime Mystery Thriller;Basic Instinct 2;1,35E+16;38629478;1140;Basic Instinct 2;46;-31370522
609;50000000;Action Thriller;Escape Plan;44478043;122915111;1150;Escape Plan;67;72915111
610;70000000;Action Adventure;The Legend of Hercules;25020428;61279452;990;The Legend of Hercules;44;-8720548
611;68000000;Thriller Action Drama;The Sum of All Fears;22392544;193000000;1240;The Sum of All Fears;59;125000000
612;68000000;Adventure Fantasy Drama Romance;The Twilight Saga: Eclipse;107069763;698491347;1240;The Twilight Saga: Eclipse;58;630491347
613;68000000;Action Crime Thriller;The Score;22572323;71069884;1240;The Score;67;3069884
614;69000000;Animation Family;Despicable Me;113858273;543513985;950;Despicable Me;71;474513985
615;60000000;Action Comedy Crime;Money Train;10004564;35431113;1030;Money Train;54;-24568887
616;68000000;Comedy;Ted 2;68734513;217022588;1150;Ted 2;62;149022588
617;70000000;Adventure Drama History;Agora;18888806;39041505;1270;Agora;69;-30958495
618;68000000;Adventure Fantasy Action Comedy Science Fiction;Mystery Men;12948627;29762011;1210;Mystery Men;57;-38237989
619;36000000;Comedy;Hall Pass;2,71E+16;83160734;1050;Hall Pass;54;47160734
620;90000000;Drama Thriller;The Insider;26153669;60289912;1570;The Insider;73;-29710088
621;80000000;Action Drama History Thriller;The Finest Hours;2,82E+15;52099090;1140;The Finest Hours;63;-27900910
622;70000000;Action Drama Thriller;Body of Lies;3,75E+16;113280098;1280;Body of Lies;65;43280098
623;69000000;Comedy;Dinner for Schmucks;11023691;86387857;1140;Dinner for Schmucks;55;17387857
624;69000000;Action Fantasy Horror;Abraham Lincoln: Vampire Hunter;38634767;112265139;940;Abraham Lincoln: Vampire Hunter;55;43265139
625;66000000;Romance Drama Mystery;Entrapment;25877794;212404396;1120;Entrapment;60;146404396
626;66000000;Mystery Science Fiction Thriller;The X Files;1859991;189198313;1210;The X Files;66;123198313
627;67000000;Action Adventure Fantasy War;The Last Legion;12282911;25303038;1020;The Last Legion;50;-41696962
628;70000000;Drama History War;Saving Private Ryan;7,60E+15;481840909;1690;Saving Private Ryan;79;411840909
629;66000000;Action Crime Drama Thriller;Need for Speed;5,48E+15;203277636;1300;Need for Speed;61;137277636
630;70000000;Comedy Romance;What Women Want;3139165;374111707;1270;What Women Want;61;304111707
631;59000000;Animation Comedy Family Adventure;Ice Age;99561972;383257136;810;Ice Age;71;324257136
632;68000000;Drama Horror Science Fiction Thriller;Dreamcatcher;26792794;75715436;1360;Dreamcatcher;53;7715436
633;65000000;History Drama;Lincoln;36307296;275293450;1490;Lincoln;67;210293450
634;63000000;Action Science Fiction;The Matrix;104309993;463517383;1360;The Matrix;79;400517383
635;52000000;Drama;Apollo 13;68140214;355237933;1400;Apollo 13;73;303237933
636;65000000;Fantasy Comedy Family;The Santa Clause 2;14646884;172855065;1040;The Santa Clause 2;55;107855065
637;61000000;Drama Music Romance;Les Misérables;48356214;441809770;1570;Les Misérables;71;380809770
638;65000000;Comedy Romance;You've Got Mail;28540267;250821495;1190;You've Got Mail;63;185821495
639;65000000;Comedy;Step Brothers;22977983;128107642;980;Step Brothers;65;63107642
640;95000000;Action Adventure;The Mask of Zorro;3,11E+16;250288523;1360;The Mask of Zorro;63;155288523
641;65000000;Comedy Drama;Due Date;43865294;211780824;950;Due Date;62;146780824
642;65000000;Drama War;Unbroken;43055253;163442937;1370;Unbroken;73;98442937
643;65000000;Action Adventure Thriller;Space Cowboys;15772081;128884132;1300;Space Cowboys;63;63884132
644;70000000;Action Adventure Thriller;Cliffhanger;2,62E+16;255000211;1120;Cliffhanger;61;185000211
645;50000000;Action Adventure Drama Thriller;Broken Arrow;22769108;150270147;1080;Broken Arrow;57;100270147
646;65000000;Fantasy Comedy Family;The Kid;1,83E+16;69700000;1040;The Kid;60;4700000
647;63000000;Drama History Thriller;World Trade Center;24697533;162945894;1280;World Trade Center;59;99945894
648;65000000;Drama Romance;Mona Lisa Smile;19718544;0;1170;Mona Lisa Smile;65;-65000000
649;65000000;Comedy;The Dictator;3,13E+16;179379533;830;The Dictator;59;114379533
650;65000000;Mystery Drama;Eyes Wide Shut;27870312;162091208;1590;Eyes Wide Shut;71;97091208
651;65000000;Comedy Drama Family;Annie;33439187;133821816;1190;Annie;60;68821816
652;50100000;Romance Comedy Crime Drama;Focus;5,96E+15;153962963;1050;Focus;67;103862963
653;65000000;Action Comedy Romance;This Means War;3,90E+16;156974557;1030;This Means War;59;91974557
654;65000000;Science Fiction Action Horror Thriller Adventure;Blade: Trinity;49660055;128905366;1230;Blade: Trinity;57;63905366
655;4200000;Action Thriller;Red Dawn;11743085;38376497;1140;Red Dawn;64;34176497
656;65000000;Comedy Drama;Primary Colors;9110247;0;1430;Primary Colors;61;-65000000
657;65000000;Action Horror Science Fiction;Resident Evil: Retribution;6227675;240159255;950;Resident Evil: Retribution;56;175159255
658;45000000;Action Thriller Science Fiction;Death Race;4257877;73762516;1050;Death Race;60;28762516
659;65000000;Crime Action Mystery Thriller;The Long Kiss Goodnight;15858629;89456761;1200;The Long Kiss Goodnight;65;24456761
660;65000000;Action Adventure Drama Romance Thriller;Proof of Life;14866901;0;1350;Proof of Life;60;-65000000
661;65000000;Family Fantasy Science Fiction Adventure;Zathura: A Space Adventure;1,52E+16;64321501;1010;Zathura: A Space Adventure;61;-678499
662;63000000;Drama;Fight Club;1,47E+16;100853753;1390;Fight Club;83;37853753
663;65000000;Drama;We Are Marshall;8629665;43545364;1240;We Are Marshall;67;-21454636
664;65000000;Action Adventure Comedy;Hudson Hawk;16803457;17218080;1000;Hudson Hawk;54;-47781920
665;65000000;Action Adventure Comedy Crime Romance;Lucky Numbers;2952595;0;1050;Lucky Numbers;49;-65000000
666;65000000;Horror Thriller;I, Frankenstein;3,13E+15;71154592;920;I, Frankenstein;50;6154592
667;50000000;Crime Drama Family;Oliver Twist;20415572;42093706;1300;Oliver Twist;67;-7906294
668;43000000;Action Fantasy;Elektra;28613892;56681566;970;Elektra;48;13681566
669;65000000;Crime Thriller;Sin City: A Dame to Kill For;85428395;39407616;1020;Sin City: A Dame to Kill For;63;-25592384
670;64000000;Drama Romance;Random Hearts;4137237;74608570;1330;Random Hearts;53;10608570
671;55000000;Adventure Drama;Everest;6,02E+15;203427584;1210;Everest;67;148427584
672;50000000;Crime Fantasy Drama;Perfume: The Story of a Murderer;42551902;132180323;1470;Perfume: The Story of a Murderer;71;82180323
673;63000000;Comedy Crime Science Fiction;Austin Powers in Goldmember;40137264;296655431;940;Austin Powers in Goldmember;59;233655431
674;65000000;Animation Action Family Science Fiction;Astro Boy;2,49E+16;44091067;940;Astro Boy;61;-20908933
675;63000000;Adventure Science Fiction;Jurassic Park;40413191;920100000;1270;Jurassic Park;76;857100000
676;63000000;Drama Action Western;Wyatt Earp;1,39E+16;25052000;1910;Wyatt Earp;65;-37948000
677;62000000;Action Drama Thriller;Clear and Present Danger;1,88E+16;215887717;1410;Clear and Present Danger;64;153887717
678;65000000;Action Drama Adventure;天將雄師;9,57E+15;121545703;1270;Dragon Blade;59;56545703
679;64000000;Comedy Crime;Little Man;1,24E+16;101595121;980;Little Man;53;37595121
680;62000000;Action Drama Thriller War;U-571;18096884;127666415;1160;U-571;61;65666415
681;62000000;Comedy Drama Romance;The American President;11056763;107879496;1060;The American President;65;45879496
682;62000000;Comedy Romance;The Love Guru;13218008;41819064;870;The Love Guru;43;-20180936
683;62000000;Action Adventure Comedy Thriller Crime;3000 Miles to Graceland;11262655;18720175;1250;3000 Miles to Graceland;58;-43279825
684;44000000;Crime Drama Mystery Western;The Hateful Eight;68717016;155760117;1670;The Hateful Eight;76;111760117
685;53000000;Action Comedy Drama;Blades of Glory;19412028;0;930;Blades of Glory;59;-53000000
686;63000000;Animation Comedy Family;Hop;16791058;183953723;950;Hop;55;120953723
687;65000000;Action Adventure War;300;65197968;422610419;1170;300;70;357610419
688;80000000;Comedy Romance;Meet the Fockers;32829538;516642939;1150;Meet the Fockers;61;436642939
689;60000000;Comedy Family;Marley & Me;3,10E+16;244082376;1150;Marley & Me;69;184082376
690;60000000;Fantasy Drama Crime;The Green Mile;103698022;284600000;1890;The Green Mile;82;224600000
691;0;Action Adventure Comedy;Wild Hogs;31719463;253625427;1000;Wild Hogs;56;253625427
692;150000000;Animation Family Comedy;Chicken Little;47973995;314432665;810;Chicken Little;56;164432665
693;61000000;Mystery Thriller Drama;Gone Girl;143041543;369330363;1450;Gone Girl;79;308330363
694;60000000;Action Drama Mystery Thriller;The Bourne Identity;8,65E+15;214034224;1190;The Bourne Identity;73;154034224
695;58000000;Adventure Action Thriller;GoldenEye;59824565;352194034;1300;GoldenEye;66;294194034
696;60000000;Crime Drama Mystery Thriller;The General's Daughter;18345613;149705852;1160;The General's Daughter;61;89705852
697;60000000;Comedy Drama;The Truman Show;56488027;264118201;1030;The Truman Show;78;204118201
698;70000000;Adventure Animation Drama Family Music;The Prince of Egypt;29464852;218613188;990;The Prince of Egypt;68;148613188
699;60000000;Comedy Family;Daddy Day Care;18106021;164433867;920;Daddy Day Care;56;104433867
700;61000000;Action Comedy Crime;2 Guns;4,29E+16;131940411;1090;2 Guns;66;70940411
701;60000000;Comedy Family;Cats & Dogs;18735024;93375151;870;Cats & Dogs;50;33375151
702;60000000;Action Crime;The Italian Job;62766854;176070171;1100;The Italian Job;66;116070171
703;60000000;Romance Comedy;Two Weeks Notice;2,42E+16;93354918;1010;Two Weeks Notice;59;33354918
704;60000000;Adventure Animation Comedy Family;Antz;4,15E+15;171757863;830;Antz;60;111757863
705;70000000;Comedy Romance;Couples Retreat;2,67E+16;171844840;1130;Couples Retreat;53;101844840
706;60000000;Adventure;Days of Thunder;16278022;157920733;1070;Days of Thunder;59;97920733
707;60000000;Comedy;Cheaper by the Dozen 2;1,88E+16;129181830;940;Cheaper by the Dozen 2;57;69181830
708;61000000;Action;Maze Runner: The Scorch Trials;113161483;311256926;1320;Maze Runner: The Scorch Trials;64;250256926
709;60000000;Drama;Eat Pray Love;28800112;204594016;1330;Eat Pray Love;58;144594016
710;60000000;Comedy Drama Romance Fantasy;The Family Man;19705489;0;1250;The Family Man;65;-60000000
711;58000000;Action Adventure Comedy Crime Thriller;RED;41430245;71664962;1110;RED;66;13664962
712;55000000;Drama;Any Given Sunday;23127561;100230832;1630;Any Given Sunday;68;45230832
713;60000000;Drama Romance;The Horse Whisperer;12867352;186883563;1700;The Horse Whisperer;67;126883563
714;65000000;Drama Crime Thriller;Collateral;44815022;217764291;1200;Collateral;70;152764291
715;60000000;Action Fantasy Adventure;The Scorpion King;37537093;165333180;920;The Scorpion King;53;105333180
716;60000000;Drama Action Thriller;Ladder 49;1099991;74541707;1150;Ladder 49;62;14541707
717;60000000;Crime Drama Thriller;Jack Reacher;56868399;218340595;1300;Jack Reacher;63;158340595
718;60000000;Action Science Fiction Thriller;Deep Blue Sea;22991269;73648228;1050;Deep Blue Sea;56;13648228
719;60000000;Music Documentary;Michael Jackson's This Is It;15798622;0;1110;This Is It;67;-60000000
720;60000000;Drama Thriller Science Fiction;Contagion;38820858;137551594;1060;Contagion;62;77551594
721;0;Comedy Adventure Crime;Kangaroo Jack;10292864;0;890;Kangaroo Jack;43;0
722;60000000;Animation Family;Coraline;5,11E+16;124596398;1000;Coraline;73;64596398
723;60000000;Thriller Science Fiction;The Happening;20501582;163403799;910;The Happening;49;103403799
724;70000000;Action Drama Thriller Crime;Man on Fire;45299089;130293714;1460;Man on Fire;73;60293714
725;50000000;Comedy Family;The Shaggy Dog;4,28E+16;61112916;980;The Shaggy Dog;45;11112916
726;60000000;Comedy Crime;Starsky & Hutch;2,88E+16;170268750;1010;Starsky & Hutch;56;110268750
727;60000000;Family Comedy;Jingle All the Way;22501041;129832389;890;Jingle All the Way;55;69832389
728;66000000;Fantasy Action Science Fiction;Hellboy;47479755;99318987;1220;Hellboy;65;33318987
729;70000000;Drama;A Civil Action;10147321;56702901;1150;A Civil Action;61;-13297099
730;60000000;Family Animation Adventure Comedy;ParaNorman;39539045;107139399;900;ParaNorman;67;47139399
731;60000000;Action Thriller Adventure Crime;The Jackal;19747459;159330280;1240;The Jackal;61;99330280
732;60000000;Action Adventure Mystery Science Fiction Thriller;Paycheck;29018826;96269812;1190;Paycheck;59;36269812
733;60000000;Drama Romance;Up Close & Personal;4801849;0;1190;Up Close & Personal;59;-60000000
734;60000000;Adventure Animation Family;The Tale of Despereaux;16493576;50877145;930;The Tale of Despereaux;58;-9122855
735;0;Thriller Action Comedy Science Fiction;The Tuxedo;21549232;0;980;The Tuxedo;53;0
736;60000000;Action Thriller;Under Siege 2: Dark Territory;13080725;104324083;1000;Under Siege 2: Dark Territory;56;44324083
737;60000000;Action Drama Thriller;Jack Ryan: Shadow Recruit;42538258;50549107;1050;Jack Ryan: Shadow Recruit;59;-9450893
738;60000000;Drama Comedy;Joy;29876507;101134059;1240;Joy;64;41134059
739;60000000;Action Crime Thriller;London Has Fallen;6,18E+16;205754447;990;London Has Fallen;58;145754447
740;70000000;Science Fiction Horror Action;Alien: Resurrection;3744963;162000000;1090;Alien: Resurrection;59;92000000
741;61000000;Action Drama Mystery Thriller Crime;Shooter;37378081;95696996;1240;Shooter;69;34696996
742;60000000;Animation Comedy Family Fantasy;The Boxtrolls;30656345;108255770;970;The Boxtrolls;66;48255770
743;75000000;Drama Fantasy Comedy;Practical Magic;15142701;46683377;1040;Practical Magic;63;-28316623
744;60000000;Adventure Animation Comedy Family Fantasy;The Lego Movie;5,95E+15;469160692;1000;The Lego Movie;75;409160692
745;0;Action Comedy;Miss Congeniality 2: Armed and Fabulous;19998581;0;1150;Miss Congeniality 2: Armed and Fabulous;53;0
746;60000000;Adventure Action Fantasy;Reign of Fire;2,76E+15;43061982;1010;Reign of Fire;60;-16938018
747;60000000;Crime Drama Action Thriller;Gangster Squad;2,90E+16;105200903;1130;Gangster Squad;62;45200903
748;60000000;Comedy Adventure;Year One;25293538;62357900;970;Year One;46;2357900
749;60000000;Drama History;Invictus;2385119;122233971;1340;Invictus;70;62233971
750;60000000;Action;State of Play;21685719;87784194;1270;State of Play;67;27784194
751;78146652;Romance Comedy Crime;Duplicity;13630049;60000000;1250;Duplicity;57;-18146652
752;65000000;Comedy Drama Family Science Fiction;My Favorite Martian;680692;36850101;940;My Favorite Martian;51;-28149899
753;60000000;Action Thriller Crime;The Sentinel;15352807;77920346;1080;The Sentinel;58;17920346
754;70000000;Science Fiction Animation Family Comedy Adventure;Planet 51;23661071;104945765;910;Planet 51;56;34945765
755;60000000;Science Fiction Action Adventure Thriller;Star Trek: Nemesis;2,16E+16;67312826;1170;Star Trek: Nemesis;61;7312826
756;60000000;Crime Comedy Romance;Intolerable Cruelty;22620125;119940815;1000;Intolerable Cruelty;58;59940815
757;0;Drama Romance;Trouble with the Curve;18587114;0;1110;Trouble with the Curve;66;0
758;80000000;Crime Drama Mystery Thriller;Edge of Darkness;24657931;74901339;1170;Edge of Darkness;62;-5098661
759;60000000;Horror Mystery Thriller;The Relic;12621769;33956608;1100;The Relic;58;-26043392
760;60000000;Comedy Crime;Analyze That;2108952;55003135;960;Analyze That;57;-4996865
761;60000000;Action Crime Drama Thriller;Righteous Kill;1,84E+16;73174566;1010;Righteous Kill;59;13174566
762;60000000;Action Crime Drama Thriller;Mercury Rising;1,89E+16;0;1110;Mercury Rising;60;-60000000
763;60000000;Drama;The Soloist;1,73E+16;31720158;1090;The Soloist;66;-28279842
764;80000000;Fantasy Drama;The Legend of Bagger Vance;16848899;39459427;1260;The Legend of Bagger Vance;63;-40540573
765;60000000;Drama Music;Almost Famous;21547446;47383689;1220;Almost Famous;74;-12616311
766;0;Animation Comedy Family;Garfield: A Tail of Two Kitties;16930969;141702264;780;Garfield: A Tail of Two Kitties;51;141702264
767;60000000;Action Adventure Crime Drama Mystery;xXx: State of the Union;36689223;71073932;1010;xXx: State of the Union;47;11073932
768;60000000;Action Science Fiction Fantasy Thriller Horror;Priest;2,84E+16;78309131;870;Priest;54;18309131
769;60000000;Family Animation Adventure;Sinbad: Legend of the Seven Seas;18815442;26288320;860;Sinbad: Legend of the Seven Seas;66;-33711680
770;60000000;Horror Science Fiction Mystery;Event Horizon;29787135;26673242;960;Event Horizon;65;-33326758
771;60000000;Drama;Dragonfly;8927137;52322400;1040;Dragonfly;61;-7677600
772;50000000;Drama;The Black Dahlia;15213484;49111202;1210;The Black Dahlia;57;-888798
773;60000000;Action Adventure Drama History Romance;Flyboys;13155999;17800000;1400;Flyboys;63;-42200000
774;72000000;Action Drama Thriller;The Last Castle;15433244;27642707;1310;The Last Castle;70;-44357293
775;90000000;Horror Science Fiction Thriller;Supernova;5762037;14828081;910;Supernova;49;-75171919
776;60000000;Drama Fantasy Mystery Romance;Winter's Tale;22736038;30800231;1180;Winter's Tale;60;-29199769
777;60000000;Action Adventure Drama Mystery Romance;The Mortal Instruments: City of Bones;45514031;90565421;1300;The Mortal Instruments: City of Bones;62;30565421
778;60000000;Comedy Science Fiction Adventure Family;Meet Dave;18676291;50650079;900;Meet Dave;50;-9349921
779;30000000;Drama Horror Thriller;Dark Water;1,44E+16;25473093;1050;Dark Water;53;-4526907
780;80000000;Comedy;Edtv;14298297;0;1220;Edtv;57;-80000000
781;60000000;Adventure Family Fantasy;Inkheart;27018886;57490374;1060;Inkheart;60;-2509626
782;60000000;Action Comedy Thriller Crime Science Fiction;The Spirit;1484856;39031337;1030;The Spirit;47;-20968663
783;60000000;Comedy Adventure;Mortdecai;5,24E+16;30418560;1060;Mortdecai;54;-29581440
784;60000000;Adventure Fantasy Action Drama;In the Name of the King: A Dungeon Siege Tale;15406173;0;1270;In the Name of the King: A Dungeon Siege Tale;41;-60000000
785;35000000;Drama Romance Adventure War;Beyond Borders;6523472;0;1270;Beyond Borders;67;-35000000
786;68490000;Action Adventure Fantasy;西游记之孙悟空三打白骨精;4,73E+16;193677158;1200;The Monkey King 2;60;125187158
787;80000000;Action History War;The Great Raid;8,92E+15;10166502;1320;The Great Raid;68;-69833498
788;58000000;Action Adventure Comedy;Deadpool;5,15E+15;783112979;1080;Deadpool;74;725112979
789;60000000;Drama Comedy;Holy Man;9265672;0;1140;Holy Man;49;-60000000
790;58800000;War Action;American Sniper;8753437;542307423;1330;American Sniper;74;483507423
791;58000000;Adventure Horror Comedy;Goosebumps;45351617;158162788;1030;Goosebumps;62;100162788
792;58000000;Comedy Fantasy Romance;Just Like Heaven;1343573;102854431;950;Just Like Heaven;65;44854431
793;83000000;Science Fiction Comedy Family Romance;The Flintstones in Viva Rock Vegas;6248309;59468275;900;The Flintstones in Viva Rock Vegas;44;-23531725
794;63000000;Action Adventure Thriller War;Rambo III;31294717;189015611;1020;Rambo III;57;126015611
795;58000000;Comedy Romance Drama;Leatherheads;7,74E+16;41299492;1140;Leatherheads;57;-16700508
796;60000000;Comedy Western;The Ridiculous 6;19694695;0;1190;The Ridiculous 6;49;-60000000
797;58000000;Comedy;Did You Hear About the Morgans?;14403696;85280250;1030;Did You Hear About the Morgans?;51;27280250
798;58000000;Comedy;The Internship;1551497;44000000;1190;The Internship;61;-14000000
799;60000000;Action Adventure Horror Science Fiction;Resident Evil: Afterlife;2143764;300228084;970;Resident Evil: Afterlife;58;240228084
800;58000000;Drama Action Adventure History War;Red Tails;1229603;50365377;1250;Red Tails;59;-7634623
801;57000000;Drama Horror Mystery Thriller;The Devil's Advocate;338473;152944660;1440;The Devil's Advocate;72;95944660
802;70000000;Comedy;That's My Boy;21723897;58058367;1160;That's My Boy;55;-11941633
803;57000000;Fantasy;DragonHeart;3,18E+16;115267375;1030;DragonHeart;64;58267375
804;60000000;Action Comedy Crime Drama;After the Sunset;14113066;61347797;970;After the Sunset;60;1347797
805;57000000;Action Fantasy Thriller;Ghost Rider: Spirit of Vengeance;48622278;149217355;950;Ghost Rider: Spirit of Vengeance;47;92217355
806;57000000;Drama History Romance;Captain Corelli's Mandolin;9061866;62112895;1310;Captain Corelli's Mandolin;55;5112895
807;56000000;Action Comedy Drama Family Thriller;The Pacifier;354763;113006880;950;The Pacifier;58;57006880
808;56000000;Adventure Drama Action Thriller;Walking Tall;23438398;57223890;860;Walking Tall;60;1223890
809;55000000;Comedy Drama Romance;Forrest Gump;138133331;677945399;1420;Forrest Gump;82;622945399
810;60000000;Comedy Music Family Fantasy Animation;Alvin and the Chipmunks;4,73E+15;361366633;920;Alvin and the Chipmunks;55;301366633
811;55000000;Comedy Romance;Meet the Parents;3,00E+15;330444045;1080;Meet the Parents;66;275444045
812;55000000;Adventure Animation Drama Family;Pocahontas;4,78E+16;346079773;810;Pocahontas;67;291079773
813;55000000;Action Adventure Fantasy Science Fiction;Superman;48507081;300218018;1430;Superman;69;245218018
814;54000000;Fantasy Comedy Romance Science Fiction;The Nutty Professor;2028119;128769345;950;The Nutty Professor;54;74769345
815;70000000;Comedy Drama Romance;Hitch;34576913;368100420;1180;Hitch;64;298100420
816;55000000;Adventure Comedy Family Romance;George of the Jungle;22573237;0;920;George of the Jungle;54;-55000000
817;55000000;Comedy Romance;American Wedding;36194802;231449203;1030;American Wedding;60;176449203
818;55000000;Action Drama Thriller;Captain Phillips;52786917;95000000;1340;Captain Phillips;76;40000000
819;55000000;Comedy;Date Night;3,81E+16;152263880;970;Date Night;59;97263880
820;50000000;Fantasy Comedy Family;Casper;19830132;287928194;1000;Casper;60;237928194
821;55000000;Thriller Action Crime;The Equalizer;7,99E+15;192330738;1320;The Equalizer;71;137330738
822;55000000;Comedy Drama Romance;Maid in Manhattan;19738215;154906693;1050;Maid in Manhattan;56;99906693
823;53000000;Action Thriller Drama;Crimson Tide;20334629;157387195;1160;Crimson Tide;70;104387195
824;55000000;Drama;The Pursuit of Happyness;80581367;307077295;1170;The Pursuit of Happyness;77;252077295
825;55000000;Thriller Drama Mystery;Flightplan;3205145;223387299;980;Flightplan;61;168387299
826;55000000;Drama Thriller Crime Mystery Romance;Disclosure;15064058;214015089;1230;Disclosure;59;159015089
827;55000000;Drama Fantasy Romance;City of Angels;21272734;198685114;1140;City of Angels;64;143685114
828;30000000;Action Crime;Kill Bill: Vol. 1;7,98E+15;180949000;1110;Kill Bill: Vol. 1;77;150949000
829;55000000;Comedy;Bowfinger;13191829;0;970;Bowfinger;60;-55000000
830;30000000;Action Crime Thriller;Kill Bill: Vol. 2;50622607;152159461;1360;Kill Bill: Vol. 2;76;122159461
831;55000000;Action Adventure Comedy;Tango & Cash;2,28E+15;63408614;1040;Tango & Cash;61;8408614
832;55000000;Fantasy Comedy;Death Becomes Her;2,95E+16;149022650;1040;Death Becomes Her;63;94022650
833;55000000;Adventure Action Comedy Western;Shanghai Noon;25400935;56932305;1100;Shanghai Noon;62;1932305
834;55000000;Action Adventure Drama Thriller;Executive Decision;17231675;121969216;1330;Executive Decision;58;66969216
835;55000000;Comedy Family;Mr. Popper's Penguins;32835777;187361754;940;Mr. Popper's Penguins;57;132361754
836;55000000;Action Adventure Fantasy;The Forbidden Kingdom;17097041;127906624;1040;The Forbidden Kingdom;63;72906624
837;55000000;Animation Comedy Family;Free Birds;14414937;110000000;910;Free Birds;57;55000000
838;50000000;Science Fiction Action Horror;Alien³;45856409;159773545;1140;Alien³;62;109773545
839;55000000;History Drama Music;Evita;7027139;141047179;1340;Evita;59;86047179
840;55000000;Action Thriller Crime Adventure;Ronin;32657488;41610884;1220;Ronin;67;-13389116
841;50000000;Adventure;The Ghost and the Darkness;1246525;75000000;1090;The Ghost and the Darkness;64;25000000
842;55000000;Family Comedy;Paddington;39882276;259207227;950;Paddington;70;204207227
843;68000000;Comedy;The Watch;39395881;68267862;980;The Watch;53;267862
844;55000000;Drama Action Thriller Crime;The Hunted;8,63E+15;34234008;940;The Hunted;60;-20765992
845;80000000;Drama Mystery Thriller;Instinct;7386394;0;1260;Instinct;62;-80000000
846;55000000;Comedy;Stuck on You;8802525;33828318;1180;Stuck on You;51;-21171682
847;0;Comedy;Semi-Pro;10449975;33472850;910;Semi-Pro;54;33472850
848;60000000;Animation Adventure Family Comedy;The Pirates! In an Adventure with Scientists!;2,37E+16;118338361;880;The Pirates! In an Adventure with Scientists!;64;58338361
849;55000000;Crime Drama Mystery;Changeling;2,75E+16;113020255;1410;Changeling;73;58020255
850;50000000;Action Drama Science Fiction Thriller;Chain Reaction;2,06E+16;60209334;1070;Chain Reaction;53;10209334
851;55000000;Drama Mystery Thriller;The Fan;4,37E+16;18626419;1160;The Fan;57;-36373581
852;70000000;Thriller Drama Romance;The Phantom of the Opera;18927463;154648887;1430;The Phantom of the Opera;70;84648887
853;55000000;Drama History Romance;Elizabeth: The Golden Age;15274137;74237563;1140;Elizabeth: The Golden Age;66;19237563
854;62000000;Action Science Fiction;Æon Flux;3,00E+16;52304001;930;Æon Flux;54;-9695999
855;56000000;Drama History War;Gods and Generals;4362535;12923936;2140;Gods and Generals;61;-43076064
856;55000000;Action Thriller Crime;Turbulence;4700024;11466088;1000;Turbulence;52;-43533912
857;55000000;Comedy;Imagine That;12340384;0;1070;Imagine That;57;-55000000
858;50000000;Comedy Adventure Crime Family;Muppets Most Wanted;1,48E+16;80383290;1120;Muppets Most Wanted;62;30383290
859;57000000;Action Adventure Comedy Family Fantasy;Thunderbirds;927875;28283637;950;Thunderbirds;42;-28716363
860;55000000;Drama Romance;Burlesque;22863516;89519773;1190;Burlesque;69;34519773
861;47000000;Drama;Un long dimanche de fiançailles;2305451;0;1330;A Very Long Engagement;71;-47000000
862;2000000;Drama Romance;Lolita;2,40E+16;9250000;1530;Lolita;73;7250000
863;55000000;Action Thriller;D-Tox;1,27E+16;6416302;960;D-Tox;53;-48583698
864;54000000;Fantasy Horror Action Thriller;Blade II;6,72E+15;155010032;1170;Blade II;62;101010032
865;55000000;Drama;Seven Pounds;41472404;168167691;1230;Seven Pounds;75;113167691
866;55000000;Action Crime Thriller;Bullet to the Head;2,25E+16;9489829;920;Bullet to the Head;52;-45510171
867;54000000;Crime Drama Thriller;The Godfather: Part III;59194915;136766062;1620;The Godfather: Part III;71;82766062
868;57000000;Comedy Drama Romance;Elizabethtown;22894898;52034889;1230;Elizabethtown;61;-4965111
869;54000000;Comedy Romance;You, Me and Dupree;1,86E+16;130431368;1080;You, Me and Dupree;54;76431368
870;54000000;Action Adventure Fantasy Science Fiction;Superman II;30515175;190458706;1270;Superman II;65;136458706
871;54000000;Drama;Gigli;9053456;7266209;1210;Gigli;35;-46733791
872;55000000;Drama Thriller;All the King's Men;7768223;9450897;1250;All the King's Men;57;-45549103
873;46000000;Action Adventure Crime Thriller;Shaft;19643365;107196498;990;Shaft;55;61196498
874;53000000;Animation Family;Anastasia;4,56E+16;139804348;940;Anastasia;74;86804348
875;52500000;Drama Music Romance;Moulin Rouge!;57374341;179213434;1270;Moulin Rouge!;74;126713434
876;75000000;Mystery Thriller Crime;Domestic Disturbance;8,42E+15;54249294;890;Domestic Disturbance;54;-20750706
877;53000000;Crime Drama;Black Mass;46049902;98837872;1220;Black Mass;63;45837872
878;90000000;War Drama History;Flags of Our Fathers;239366;65900249;1320;Flags of Our Fathers;67;-24099751
879;53000000;Drama Crime Thriller;Law Abiding Citizen;49593978;126690726;1090;Law Abiding Citizen;72;73690726
880;67000000;Thriller Action Horror;Grindhouse;16637642;25037897;1910;Grindhouse;68;-41962103
881;0;Drama Thriller;Beloved;1453765;0;1720;Beloved;59;0
882;0;Drama Romance;Lucky You;6162872;5761917;1240;Lucky You;54;5761917
883;52000000;Drama Crime;Catch Me If You Can;7,39E+15;352114312;1410;Catch Me If You Can;77;300114312
884;40000000;Thriller Drama History;Zero Dark Thirty;38306954;132820716;1570;Zero Dark Thirty;67;92820716
885;52000000;Romance Comedy;The Break-Up;2,63E+16;204999686;1060;The Break-Up;56;152999686
886;52000000;Comedy Romance;Mamma Mia!;30780599;609841637;1080;Mamma Mia!;64;557841637
887;52000000;Comedy Romance;Valentine's Day;2541929;216485654;1250;Valentine's Day;57;164485654
888;50000000;Action Adventure Comedy;The Dukes of Hazzard;1,60E+16;110803676;1040;The Dukes of Hazzard;51;60803676
889;52000000;Drama History War;The Thin Red Line;40072583;98126565;1700;The Thin Red Line;72;46126565
890;52000000;Comedy;The Change-Up;3,20E+16;75450437;1120;The Change-Up;59;23450437
891;82000000;Comedy Drama Romance;Man on the Moon;24444186;47434430;1180;Man on the Moon;69;-34565570
892;52000000;Drama Crime;Casino;4006688;116112375;1780;Casino;78;64112375
893;52000000;Action Crime Thriller;From Paris with Love;27916284;52826594;920;From Paris with Love;61;826594
894;52000000;Action Comedy Fantasy;Bulletproof Monk;1,52E+16;0;1040;Bulletproof Monk;51;-52000000
895;51000000;Comedy;Me, Myself & Irene;39001682;149270999;1160;Me, Myself & Irene;61;98270999
896;51000000;Animation Comedy Family;Barnyard;10430832;72779000;900;Barnyard;53;21779000
897;0;Comedy Family;Deck the Halls;5952527;47231070;930;Deck the Halls;51;47231070
898;50000000;Adventure Fantasy Drama Romance;The Twilight Saga: New Moon;94815867;709827462;1300;The Twilight Saga: New Moon;56;659827462
899;60000000;Adventure Animation Comedy Family Fantasy;Shrek;67298732;484409218;900;Shrek;73;424409218
900;50200000;Science Fiction Thriller Romance;The Adjustment Bureau;2660772;127869379;1060;The Adjustment Bureau;65;77669379
901;48000000;Adventure;Robin Hood: Prince of Thieves;2,88E+16;390493908;1430;Robin Hood: Prince of Thieves;66;342493908
902;50000000;Comedy Drama Romance;Jerry Maguire;2,70E+16;273552592;1390;Jerry Maguire;67;223552592
903;50000000;Comedy Fantasy;Ted;6887691;549368315;1060;Ted;63;499368315
904;50000000;Comedy Romance;As Good as It Gets;37885022;314178011;1390;As Good as It Gets;72;264178011
905;50000000;Comedy Drama;Patch Adams;35537397;202292902;1150;Patch Adams;70;152292902
906;50000000;Comedy;Anchorman 2: The Legend Continues;38125008;173649015;1190;Anchorman 2: The Legend Continues;60;123649015
907;50000000;Comedy Romance;Mr. Deeds;1,81E+16;171269535;960;Mr. Deeds;56;121269535
908;50000000;Thriller Science Fiction Mystery;Super 8;37069253;260095987;1120;Super 8;66;210095987
909;52000000;Drama;Erin Brockovich;30347332;256271286;1310;Erin Brockovich;71;204271286
910;50000000;Comedy Romance;How to Lose a Guy in 10 Days;2,39E+16;177371441;1160;How to Lose a Guy in 10 Days;63;127371441
911;50000000;Crime Comedy Action;22 Jump Street;52380982;188441614;1120;22 Jump Street;70;138441614
912;60000000;Horror Romance;Interview with the Vampire;50163785;223664608;1230;Interview with the Vampire;72;163664608
913;70000000;Comedy;Yes Man;43849351;225990978;1040;Yes Man;64;155990978
914;50000000;Action Comedy;Central Intelligence;45318703;216972543;1070;Central Intelligence;62;166972543
915;0;Drama Romance;Stepmom;1,64E+16;0;1240;Stepmom;69;0
916;50000000;Comedy;Daddy's Home;38616744;242786137;960;Daddy's Home;58;192786137
917;50000000;Fantasy Comedy Music;Into the Woods;6,59E+15;212902372;1250;Into the Woods;56;162902372
918;45000000;Crime Drama Thriller;Inside Man;45220386;184376254;1290;Inside Man;73;139376254
919;90000000;Drama Action Thriller Crime;Payback;17457947;161626121;1000;Payback;67;71626121
920;50000000;Action Adventure Drama Mystery Science Fiction;Congo;10755847;152022101;1090;Congo;50;102022101
921;50000000;Drama Comedy Family;We Bought a Zoo;38629763;120081841;1240;We Bought a Zoo;65;70081841
922;50000000;Action Adventure Drama Mystery Science Fiction;Knowing;32693093;155446362;1210;Knowing;59;105446362
923;50000000;Comedy;Failure to Launch;18806031;88715192;970;Failure to Launch;55;38715192
924;50000000;Drama Horror Thriller;The Ring Two;32233713;161451538;1100;The Ring Two;54;111451538
925;50000000;Comedy Drama Romance;Crazy, Stupid, Love.;37990705;142851197;1180;Crazy, Stupid, Love.;70;92851197
926;50000000;Animation Comedy Family;Garfield;17667826;200804534;800;Garfield;52;150804534
927;60000000;Comedy Family;Christmas with the Kranks;9225166;0;990;Christmas with the Kranks;52;-60000000
928;50000000;Drama;Moneyball;46180421;110206216;1330;Moneyball;70;60206216
929;50000000;Action Drama Science Fiction Thriller;Outbreak;3,04E+16;189859560;1270;Outbreak;63;139859560
930;50000000;Action Thriller Mystery;Non-Stop;83295796;222809600;1060;Non-Stop;68;172809600
931;50000000;Adventure Family Fantasy Science Fiction Thriller;Race to Witch Mountain;23935053;106303988;980;Race to Witch Mountain;55;56303988
932;54000000;Action Thriller Fantasy;V for Vendetta;84630969;132511035;1320;V for Vendetta;77;78511035
933;50000000;Action Adventure Comedy Western;Shanghai Knights;16251204;88323487;1150;Shanghai Knights;60;38323487
934;50000000;Adventure Animation Comedy Family;Curious George;9894346;69834815;860;Curious George;62;19834815
935;50000000;Comedy Family Adventure Fantasy Romance;Herbie Fully Loaded;12050755;66002004;1010;Herbie Fully Loaded;51;16002004
936;50000000;Thriller;Don't Say a Word;1,16E+16;100020092;1130;Don't Say a Word;60;50020092
937;50000000;Fantasy Horror Action;Hansel & Gretel: Witch Hunters;5,30E+15;224803475;880;Hansel & Gretel: Witch Hunters;57;174803475
938;50000000;Thriller Drama;Unfaithful;14382253;119137784;1240;Unfaithful;63;69137784
939;50000000;Action Thriller Science Fiction Adventure;I Am Number Four;43450266;144492830;1090;I Am Number Four;59;94492830
940;50000000;Drama Thriller;Syriana;16871194;94000000;1280;Syriana;63;44000000
941;50000000;Action Drama History Thriller War;13 Hours: The Secret Soldiers of Benghazi;42526529;69411370;1440;13 Hours: The Secret Soldiers of Benghazi;70;19411370
942;50000000;Romance Animation Adventure Comedy Family;The Book of Life;34890999;97437106;950;The Book of Life;73;47437106
943;45000000;Thriller;Firewall;1,82E+16;82800000;1050;Firewall;56;37800000
944;50000000;Crime Drama Thriller;Absolute Power;13576765;50068310;1210;Absolute Power;64;68310
945;50000000;Action Drama;G.I. Jane;19434672;48169156;1250;G.I. Jane;60;-1830844
946;50000000;Drama Thriller Mystery;The Game;62925175;109423648;1290;The Game;75;59423648
947;50000000;Horror Mystery;Silent Hill;32927994;97607453;1250;Silent Hill;63;47607453
948;0;Comedy;The Replacements;1,48E+16;0;1180;The Replacements;61;0
949;50000000;Comedy;American Reunion;39920035;234989584;1130;American Reunion;61;184989584
950;50000000;Action Adventure Crime Drama Mystery;The Negotiator;2,87E+16;44547681;1400;The Negotiator;68;-5452319
951;50000000;Action Thriller;Into the Storm;20566554;160602194;890;Into the Storm;58;110602194
952;50000000;Action Comedy Crime;Beverly Hills Cop III;20333953;119208989;1040;Beverly Hills Cop III;55;69208989
953;50000000;Comedy Horror Fantasy;Gremlins 2: The New Batch;3398637;41482207;1060;Gremlins 2: The New Batch;62;-8517793
954;50000000;Drama;The Judge;42472324;83719388;1410;The Judge;72;33719388
955;50000000;Action Thriller;The Peacemaker;15931084;0;1240;The Peacemaker;58;-50000000
956;45000000;Horror Action Science Fiction;Resident Evil: Apocalypse;2,99E+16;129394835;940;Resident Evil: Apocalypse;61;84394835
957;50000000;Comedy Romance;Bridget Jones: The Edge of Reason;28803802;40203020;1080;Bridget Jones: The Edge of Reason;61;-9796980
958;50000000;Thriller Crime Drama;Out of Time;14993459;55495563;1050;Out of Time;61;5495563
959;50000000;Action Thriller;On Deadly Ground;9114168;49000000;1020;On Deadly Ground;45;-1000000
960;50000000;Adventure Family Science Fiction;The Adventures of Sharkboy and Lavagirl;1,23E+16;69425966;920;The Adventures of Sharkboy and Lavagirl;44;19425966
961;40000000;Drama Adventure Romance Thriller;The Beach;41362082;144056873;1190;The Beach;63;104056873
962;50000000;Drama Comedy Romance;Raising Helen;13298205;49718611;1190;Raising Helen;59;-281389
963;40000000;Action Crime Thriller;Ninja Assassin;19085403;60462347;990;Ninja Assassin;62;20462347
964;50000000;Drama Romance;For Love of the Game;9622345;0;1370;For Love of the Game;63;-50000000
965;50000000;Drama Thriller Crime;Striptease;1,11E+16;113309743;1150;Striptease;44;63309743
966;50000000;Family Comedy;Marmaduke;1,23E+16;83761844;870;Marmaduke;50;33761844
967;50000000;Drama Fantasy;Hereafter;13365715;105197635;1290;Hereafter;58;55197635
968;50000000;Crime Drama Thriller;Murder by Numbers;1,62E+16;56714147;1200;Murder by Numbers;60;6714147
969;50000000;Action Adventure Crime Thriller;Assassins;23073933;30303072;1320;Assassins;60;-19696928
970;50000000;Crime Drama Thriller;Hannibal Rising;6,57E+16;82169884;1210;Hannibal Rising;60;32169884
971;50000000;Comedy Drama Romance;The Story of Us;622577;58900031;950;The Story of Us;59;8900031
972;44000000;Action Adventure Romance Science Fiction Thriller;The Host;42933027;63327201;1250;The Host;60;19327201
973;50000000;Action Drama Mystery Thriller Crime;Basic;1,92E+16;42792561;980;Basic;62;-7207439
974;50000000;Crime Drama Mystery Thriller;Blood Work;10089065;26199517;1100;Blood Work;61;-23800483
975;50000000;Drama Thriller Crime;The International;1,34E+16;60161391;1180;The International;60;10161391
976;50000000;Action Adventure Science Fiction Thriller;Escape from L.A.;21637234;42277365;970;Escape from L.A.;56;-7722635
977;70000000;Adventure Animation Family Fantasy Science Fiction;The Iron Giant;61245957;23159305;860;The Iron Giant;76;-46840695
978;50000000;Adventure Comedy Drama;The Life Aquatic with Steve Zissou;25237969;34808403;1190;The Life Aquatic with Steve Zissou;71;-15191597
979;50000000;War Action Drama History Thriller;Free State of Jones;2,16E+16;25035950;1390;Free State of Jones;66;-24964050
980;50000000;Drama Thriller Crime;The Life of David Gale;22442241;38955598;1300;The Life of David Gale;73;-11044402
981;40000000;Comedy Action;Man of the House;6004422;0;1000;Man of the House;54;-40000000
982;50000000;Action Crime Drama Mystery Thriller;Run All Night;7464653;71561644;1140;Run All Night;63;21561644
983;51500000;Thriller Crime Mystery;Eastern Promises;35481169;55112356;1000;Eastern Promises;72;3612356
984;50000000;Action Thriller Adventure Crime;Into the Blue;1,47E+16;44434439;1100;Into the Blue;58;-5565561
985;60000000;Adventure Drama Action History War;Joan of Arc;2,11E+16;66976317;1480;The Messenger: The Story of Joan of Arc;62;6976317
986;49900000;Comedy;Your Highness;21408222;26121638;1020;Your Highness;52;-23778362
987;50000000;Drama Thriller Mystery;Dream House;19267479;38502340;840;Dream House;58;-11497660
988;50000000;Action Drama Thriller;Mad City;3314004;10541523;1140;Mad City;59;-39458477
989;50000000;Action Adventure Comedy Family;Baby's Day Out;2,13E+16;16671505;990;Baby's Day Out;58;-33328495
990;50000000;Drama History Romance;The Scarlet Letter;744268;10382407;1350;The Scarlet Letter;55;-39617593
991;22000000;Drama Thriller;Fair Game;1,25E+16;24188922;1080;Fair Game;65;2188922
992;50000000;Action Crime;Domino;18394571;22944502;1270;Domino;60;-27055498
993;50000000;Action Thriller Mystery Romance;Jade;8189406;9851610;950;Jade;52;-40148390
994;50000000;Action Thriller Science Fiction;Gamer;27631262;40828540;950;Gamer;56;-9171460
995;60000000;Fantasy Drama Romance;Beautiful Creatures;40721373;60052138;1240;Beautiful Creatures;56;52138
996;55000000;Comedy Crime Drama Thriller;Death to Smoochy;11329727;0;1090;Death to Smoochy;59;-55000000
997;50000000;Comedy;Zoolander 2;37253774;55969000;1000;Zoolander 2;47;5969000
998;50000000;Comedy Crime;The Big Bounce;6,40E+15;6808550;880;The Big Bounce;50;-43191450
999;60000000;Comedy Drama Romance Science Fiction;What Planet Are You From?;2275331;0;1050;What Planet Are You From?;54;-60000000
1000;50000000;Fantasy Thriller Action Crime;Drive Angry;30387148;28931401;1050;Drive Angry;53;-21068599
1001;50000000;Action Adventure Science Fiction Thriller;Street Fighter: The Legend of Chun-Li;8139676;12764201;970;Street Fighter: The Legend of Chun-Li;39;-37235799
1002;49000000;Action Science Fiction Thriller;The One;2,17E+16;72700000;870;The One;57;23700000
1003;49000000;Action Comedy Thriller Crime Mystery;The Adventures of Ford Fairlane;2,81E+16;20423389;1040;The Adventures of Ford Fairlane;62;-28576611
1004;50000000;Drama Comedy;The Boat That Rocked;3102233;36348784;1160;The Boat That Rocked;72;-13651216
1005;48000000;Thriller Drama Crime;Traffic;25170217;207515725;1470;Traffic;69;159515725
1006;48000000;Adventure Action;Indiana Jones and the Last Crusade;80972475;474171806;1270;Indiana Jones and the Last Crusade;76;426171806
1007;0;Drama Romance;Anna Karenina;2,64E+16;68929150;1300;Anna Karenina;65;68929150
1008;49000000;Crime Action Science Fiction;Chappie;116700319;104399548;1200;Chappie;66;55399548
1009;73000000;Drama Mystery Thriller Crime;The Bone Collector;33884459;151493655;1180;The Bone Collector;65;78493655
1010;48000000;Crime Drama Thriller;Panic Room;53043124;196397415;1110;Panic Room;65;148397415
1011;0;Horror;The Tooth Fairy;7,17E+15;0;0;The Tooth Fairy;43;0
1012;75000000;Action Adventure Comedy;Three Kings;34973086;108000000;1140;Three Kings;66;33000000
1013;50000000;Crime Thriller;Child 44;4,04E+16;3324330;1370;Child 44;61;-46675670
1014;48000000;Adventure Comedy;Rat Race;1860049;85498534;1120;Rat Race;60;37498534
1015;48000000;Drama Science Fiction;K-PAX;30920075;50315140;1200;K-PAX;71;2315140
1016;0;Comedy Fantasy Romance Science Fiction;Kate & Leopold;11940711;0;1180;Kate & Leopold;60;0
1017;48000000;Fantasy Comedy Romance;Bedazzled;19348007;90383208;930;Bedazzled;56;42383208
1018;58000000;Music Drama Crime Romance;The Cotton Club;859075;25928721;1270;The Cotton Club;66;-32071279
1019;55000000;Western;3:10 to Yuma;4,88E+15;70016220;1220;3:10 to Yuma;69;15016220
1020;48000000;Thriller Action;Taken 3;8,88E+15;325771424;1090;Taken 3;61;277771424
1021;48000000;Romance Comedy Crime;Out of Sight;16000178;77745568;1230;Out of Sight;65;29745568
1022;47000000;Comedy Drama Thriller;The Cable Guy;19525659;102825796;960;The Cable Guy;57;55825796
1023;0;Drama;1947: Earth;1246883;528972;1010;Earth;66;528972
1024;47000000;Adventure Action Comedy Thriller Crime;Dick Tracy;7859226;103738726;1030;Dick Tracy;59;56738726
1025;48000000;Drama Crime Romance;The Thomas Crown Affair;18102572;124305181;1130;The Thomas Crown Affair;66;76305181
1026;48000000;Comedy Drama Romance;Riding in Cars with Boys;7,23E+15;35743308;1320;Riding in Cars with Boys;65;-12256692
1027;15000000;Action Adventure Thriller War;First Blood;6,31E+16;125212904;930;First Blood;72;110212904
1028;0;Drama Science Fiction Adventure Mystery;Солярис;24132271;0;1670;Solaris;77;0
1029;47000000;Animation Comedy Family Fantasy Science Fiction;Happily N'Ever After;10410933;38085778;750;Happily N'Ever After;46;-8914222
1030;47000000;Drama Horror Thriller Romance;Mary Reilly;6,07E+16;12379402;1040;Mary Reilly;57;-34620598
1031;38000000;Comedy Romance;My Best Friend's Wedding;15401855;299288605;1050;My Best Friend's Wedding;63;261288605
1032;0;Comedy Romance;America's Sweethearts;10698929;0;1020;America's Sweethearts;55;0
1033;46000000;Crime Mystery Thriller;Insomnia;41322708;113714830;1180;Insomnia;68;67714830
1034;46000000;Science Fiction Action Adventure Thriller;Star Trek: First Contact;256713;150000000;1110;Star Trek: First Contact;70;104000000
1035;47000000;Action Western Drama Fantasy Thriller;Jonah Hex;22581313;10539000;800;Jonah Hex;44;-36461000
1036;46000000;Drama Thriller Mystery War;Courage Under Fire;12971122;100860818;1170;Courage Under Fire;62;54860818
1037;45000000;Comedy;Liar Liar;26721386;181000000;860;Liar Liar;64;136000000
1038;25000000;Crime Drama Thriller;The Infiltrator;24672234;15436808;1270;The Infiltrator;66;-9563192
1039;46000000;Drama History War;Inchon;146783;5200000;1400;Inchon;65;-40800000
1040;46000000;Fantasy Comedy Family;The Flintstones;2,90E+16;341631208;910;The Flintstones;50;295631208
1041;45000000;Action Crime Thriller;Taken 2;49353524;376141306;910;Taken 2;61;331141306
1042;48000000;Comedy;Scary Movie 3;36585509;220673217;840;Scary Movie 3;58;172673217
1043;45000000;Comedy Crime Action;Miss Congeniality;32624355;212000000;1110;Miss Congeniality;61;167000000
1044;45000000;Action Science Fiction Adventure Comedy Family;Journey to the Center of the Earth;53090422;101702060;930;Journey to the Center of the Earth;58;56702060
1045;40000000;Comedy Drama Family Romance;The Princess Diaries 2: Royal Engagement;30002907;95149435;1130;The Princess Diaries 2: Royal Engagement;60;55149435
1046;45000000;Drama Mystery Thriller Crime;The Pelican Brief;17923254;195268056;1410;The Pelican Brief;63;150268056
1047;45000000;Drama Thriller Crime Mystery;The Client;17746719;117615211;1190;The Client;64;72615211
1048;45000000;Drama Comedy;The Bucket List;3,13E+16;175372502;970;The Bucket List;70;130372502
1049;45000000;Drama Action Thriller Crime;Patriot Games;19637704;178051587;1170;Patriot Games;63;133051587
1050;43000000;Romance Comedy;Monster-in-Law;10411996;154749918;1010;Monster-in-Law;56;111749918
1051;46000000;Drama Thriller Crime;Prisoners;88496873;122126687;1530;Prisoners;79;76126687
1052;45000000;Action Crime Drama Thriller;Training Day;52081131;104876233;1220;Training Day;73;59876233
1053;45000000;Comedy Family Science Fiction;Galaxy Quest;3,08E+16;90683916;1020;Galaxy Quest;69;45683916
1054;45000000;Comedy;Scary Movie 2;3,54E+15;141220678;830;Scary Movie 2;54;96220678
1055;45000000;Comedy Family Music;The Muppets;17047276;165184237;1030;The Muppets;65;120184237
1056;45000000;Horror Action;Blade;43815492;131183530;1200;Blade;65;86183530
1057;30000000;Drama;Coach Carter;23234651;76669806;1360;Coach Carter;73;46669806
1058;45000000;Action Adventure Crime Thriller;Changing Lanes;1,73E+16;94935764;890;Changing Lanes;59;49935764
1059;45000000;Adventure Horror Thriller;Anaconda;27684779;136885767;890;Anaconda;47;91885767
1060;45000000;Comedy;Coyote Ugly;2679781;113916474;1000;Coyote Ugly;58;68916474
1061;40000000;Comedy Romance Drama;Love Actually;37073127;244931766;1350;Love Actually;70;204931766
1062;120000000;Adventure Animation Comedy Family;A Bug's Life;87350802;363258859;950;A Bug's Life;68;243258859
1063;35000000;Horror Mystery Thriller;From Hell;26134678;74558115;1220;From Hell;66;39558115
1064;45000000;Action Thriller;The Specialist;16582709;170362582;1100;The Specialist;55;125362582
1065;45000000;Comedy Drama Romance;Tin Cup;10731574;53854588;1350;Tin Cup;59;8854588
1066;0;Comedy Drama Family;Yours, Mine and Ours;2,09E+16;0;1110;Yours, Mine and Ours;62;0
1067;45000000;Romance Comedy Family;Kicking & Screaming;899269;56070433;950;Kicking & Screaming;56;11070433
1068;50000000;Adventure Comedy Family Science Fiction;The Hitchhiker's Guide to the Galaxy;5,17E+16;104478416;1090;The Hitchhiker's Guide to the Galaxy;66;54478416
1069;0;Comedy Drama Family;Fat Albert;7,16E+15;0;930;Fat Albert;43;0
1070;45000000;Horror Action Science Fiction;Resident Evil: Extinction;1,21E+16;148412065;940;Resident Evil: Extinction;61;103412065
1071;40000000;Comedy;Blended;44120328;123494610;1170;Blended;66;83494610
1072;45000000;Adventure Comedy Drama;Last Holiday;6156015;38399961;1120;Last Holiday;64;-6600039
1073;45000000;Action Adventure Crime Thriller;The River Wild;12362876;0;1110;The River Wild;61;-45000000
1074;45000000;Adventure Family Fantasy;The Indian in the Cupboard;11095914;0;960;The Indian in the Cupboard;59;-45000000
1075;45000000;Crime Drama Thriller;Savages;3,19E+16;82966152;1310;Savages;62;37966152
1076;25000000;Action Adventure Crime Thriller;Cellular;24459948;56422687;940;Cellular;61;31422687
1077;40000000;Adventure Action Comedy;Johnny English;28029015;160583018;880;Johnny English;60;120583018
1078;50000000;Fantasy Adventure Animation Comedy Family;The Ant Bully;20239061;55181129;880;The Ant Bully;55;5181129
1079;40000000;Action Science Fiction Adventure;Dune;25876582;30925690;1370;Dune;65;-9074310
1080;0;Adventure Drama Music Romance;Across the Universe;1,19E+16;0;1330;Across the Universe;71;0
1081;35000000;Drama Romance;Revolutionary Road;20360549;75225693;1190;Revolutionary Road;67;40225693
1082;55000000;Action Adventure Crime Thriller;16 Blocks;3231022;65664721;1050;16 Blocks;62;10664721
1083;70000000;Action Adventure Science Fiction Thriller;Babylon A.D.;2,76E+16;72108608;1010;Babylon A.D.;54;2108608
1084;45000000;Action Adventure Crime Drama Thriller;The Glimmer Man;6250282;0;920;The Glimmer Man;47;-45000000
1085;45000000;Comedy Fantasy Science Fiction;Multiplicity;1,11E+16;0;1170;Multiplicity;55;-45000000
1086;45000000;Adventure Comedy Family Fantasy Science Fiction;Aliens in the Attic;1,37E+16;57881056;860;Aliens in the Attic;53;12881056
1087;35000000;Crime Drama Mystery Thriller;The Pledge;12495436;29400000;1230;The Pledge;65;-5600000
1088;45000000;Comedy Music;The Producers;6803965;38058335;1340;The Producers;61;-6941665
1089;45000000;Adventure Action;The Phantom;9025236;17300889;1000;The Phantom;47;-27699111
1090;57000000;Drama Romance Western;All the Pretty Horses;7,52E+16;0;1170;All the Pretty Horses;58;-57000000
1091;44000000;History Drama;Nixon;3770161;13681765;1920;Nixon;71;-30318235
1092;45000000;Thriller Mystery;The Ghost Writer;2,11E+16;60222298;1280;The Ghost Writer;67;15222298
1093;45000000;Adventure Action Horror Science Fiction;Deep Rising;6513856;11203026;1060;Deep Rising;60;-33796974
1094;45000000;Drama War;Miracle at St. Anna;11387408;9323833;1600;Miracle at St. Anna;63;-35676167
1095;110;Action Drama Fantasy;滿城盡帶黃金甲;9950505;0;1140;Curse of the Golden Flower;66;-110
1096;45000000;Action Crime Thriller;Bangkok Dangerous;14813057;42487390;990;Bangkok Dangerous;50;-2512610
1097;40000000;Action Comedy Thriller;Big Trouble;5201688;8493890;850;Big Trouble;63;-31506110
1098;45000000;Drama Romance;Love in the Time of Cholera;5361699;4607608;1390;Love in the Time of Cholera;64;-40392392
1099;45000000;Action Thriller;Shadow Conspiracy;3848893;2154540;1030;Shadow Conspiracy;40;-42845460
1100;45000000;Crime Adventure Action Comedy Thriller;Johnny English Reborn;356585;160078586;1010;Johnny English Reborn;60;115078586
1101;65000000;Animation Action Comedy Family;Foodfight!;5258726;73706;870;Foodfight!;23;-64926294
1102;44500000;Drama Thriller;Argo;6201056;232324128;1200;Argo;71;187824128
1103;44000000;Adventure Action Thriller Crime Mystery;The Fugitive;54884297;368875760;1300;The Fugitive;72;324875760
1104;40000000;Action;The Bounty Hunter;33747825;136000000;1100;The Bounty Hunter;55;96000000
1105;44000000;Crime Drama Thriller;Sleepers;16245068;165615285;1470;Sleepers;73;121615285
1106;44000000;Action Adventure Thriller War;Rambo: First Blood Part II;3,87E+16;300400432;960;Rambo: First Blood Part II;63;256400432
1107;44000000;Drama Thriller;The Juror;3,94E+16;0;1180;The Juror;55;-44000000
1108;2600000;Animation Family;Pinocchio;46007991;84300000;880;Pinocchio;69;81700000
1109;44000000;Action Drama History Western;Heaven's Gate;5,38E+16;3484331;2190;Heaven's Gate;64;-40515669
1110;50000000;Fantasy Action Science Fiction Thriller;Underworld: Evolution;49020045;111340801;1060;Underworld: Evolution;64;61340801
1111;40000000;Drama Science Fiction Thriller;Victor Frankenstein;24821138;34227298;1090;Victor Frankenstein;56;-5772702
1112;43000000;Drama;Finding Forrester;19043286;80049764;1360;Finding Forrester;70;37049764
1113;43000000;Comedy Drama;28 Days;5418921;0;1030;28 Days;60;-43000000
1114;45000000;Action Crime;Unleashed;2,60E+16;50871113;1030;Unleashed;66;5871113
1115;43000000;Romance Comedy;The Sweetest Thing;1865632;68696770;840;The Sweetest Thing;53;25696770
1116;42000000;Drama Mystery Thriller;The Firm;23736535;270248367;1540;The Firm;66;228248367
1117;44000000;Drama;Charlie St. Cloud;2175433;48190704;990;Charlie St. Cloud;68;4190704
1118;40000000;Action Thriller Crime;The Mechanic;44094856;51070807;930;The Mechanic;63;11070807
1119;42000000;Action Comedy Crime;21 Jump Street;6,27E+16;201585328;1090;21 Jump Street;67;159585328
1120;42000000;Romance Comedy Drama;Notting Hill;28969151;363889678;1240;Notting Hill;70;321889678
1121;45000000;Animation Comedy Family;Chicken Run;31789029;224834564;840;Chicken Run;65;179834564
1122;42000000;Comedy Romance;Along Came Polly;3,32E+16;171963386;900;Along Came Polly;58;129963386
1123;40000000;Comedy Romance;Boomerang;6,42E+16;70100000;1170;Boomerang;54;30100000
1124;43000000;Action Comedy Crime;The Heat;37654688;158674180;1170;The Heat;65;115674180
1125;31115000;Drama History Romance;Cleopatra;13244365;71000000;2480;Cleopatra;67;39885000
1126;0;Comedy;Here Comes the Boom;26799913;73100172;1050;Here Comes the Boom;60;73100172
1127;42000000;Drama Mystery Thriller Crime;High Crimes;14046705;63781810;1150;High Crimes;61;21781810
1128;42000000;Comedy Drama Romance;The Mirror Has Two Faces;3844926;0;1260;The Mirror Has Two Faces;65;-42000000
1129;32000000;Drama Horror Mystery;The Mothman Prophecies;14733513;55157539;1190;The Mothman Prophecies;61;23157539
1130;42000000;Comedy;Brüno;16122168;0;830;Brüno;54;-42000000
1131;32000000;Adventure Action Thriller;Licence to Kill;2,82E+16;156167015;1330;Licence to Kill;59;124167015
1132;42000000;Fantasy Thriller Horror;Red Riding Hood;45151657;89162162;1000;Red Riding Hood;56;47162162
1133;60000000;Action Crime Thriller;15 Minutes;15205371;56359980;1200;15 Minutes;57;-3640020
1134;48000000;Adventure Comedy Family Fantasy;Super Mario Bros.;14587367;20915465;1040;Super Mario Bros.;40;-27084535
1135;42000000;Crime Drama Thriller;Lord of War;34828241;24127895;1220;Lord of War;70;-17872105
1136;31000000;Drama Adventure Action History;英雄;23607392;177394432;990;Hero;72;146394432
1137;40000000;Action Comedy Crime;One for the Money;19438503;36893721;910;One for the Money;53;-3106279
1138;44000000;Action Comedy;The Interview;7,42E+15;12342632;1120;The Interview;61;-31657368
1139;42000000;Adventure Fantasy Action Western Thriller;The Warrior's Way;7349497;11087569;1000;The Warrior's Way;63;-30912431
1140;33000000;Action Comedy Crime;Micmacs à tire-larigot;7,66E+16;14000000;1000;Micmacs;68;-19000000
1141;41000000;Drama;8 Mile;32798571;215000000;1100;8 Mile;68;174000000
1142;0;Adventure Comedy Animation;Pourquoi j'ai pas mangé mon père;5,79E+15;0;1000;Why I Did (Not) Eat My Father;53;0
1143;65000000;Adventure Drama Romance Action;A Knight's Tale;3,67E+16;117487473;1320;A Knight's Tale;66;52487473
1144;41000000;Thriller Fantasy Action Comedy;The Medallion;14653718;0;880;The Medallion;53;-41000000
1145;40000000;Mystery Thriller Drama;The Sixth Sense;73085576;672806292;1070;The Sixth Sense;77;632806292
1146;42000000;Action Thriller Crime;Man on a Ledge;34041407;46221189;1020;Man on a Ledge;62;4221189
1147;41000000;Comedy;The Big Year;9,42E+15;7448385;1000;The Big Year;56;-33551615
1148;8000000;Drama;The Karate Kid;2,85E+16;90815558;1260;The Karate Kid;69;82815558
1149;40000000;Drama Crime;American Hustle;4,97E+15;251171807;1380;American Hustle;68;211171807
1150;40000000;Comedy Romance Drama;The Proposal;36238968;317375031;1080;The Proposal;67;277375031
1151;70000000;Crime Drama Mystery Thriller;Double Jeopardy;19439386;177841558;1050;Double Jeopardy;62;107841558
1152;40000000;Adventure Comedy Family Science Fiction;Back to the Future Part II;43345252;332000000;1080;Back to the Future Part II;74;292000000
1153;40000000;Action Science Fiction;Lucy;115241998;126546825;890;Lucy;63;86546825
1154;40000000;Drama Romance Thriller;Fifty Shades of Grey;98755657;571006128;1250;Fifty Shades of Grey;52;531006128
1155;38000000;Action Adventure Comedy Family Science Fiction;Spy Kids 3-D: Game Over;21998734;197011982;840;Spy Kids 3-D: Game Over;47;159011982
1156;40000000;Crime Drama Thriller;A Time to Kill;2,52E+16;152266007;1490;A Time to Kill;70;112266007
1157;40000000;Comedy;Cheaper by the Dozen;26516624;190212113;980;Cheaper by the Dozen;60;150212113
1158;40000000;Action Drama Thriller War;Lone Survivor;37084384;149295601;1210;Lone Survivor;74;109295601
1159;40000000;Comedy;A League of Their Own;2,17E+16;107458785;1280;A League of Their Own;67;67458785
1160;40000000;Horror;The Conjuring 2;68794673;320170008;1340;The Conjuring 2;70;280170008
1161;40000000;Drama;The Social Network;6,93E+15;224920315;1200;The Social Network;71;184920315
1162;40000000;Comedy Romance Drama;He's Just Not That Into You;26253357;177259441;1290;He's Just Not That Into You;62;137259441
1163;45000000;Comedy;Scary Movie 4;32549282;178262620;830;Scary Movie 4;53;133262620
1164;40000000;Horror Mystery;Scream 3;24992057;161834276;1160;Scream 3;57;121834276
1165;40000000;Adventure Comedy Family Science Fiction;Back to the Future Part III;45769562;244527583;1180;Back to the Future Part III;71;204527583
1166;40000000;Comedy;Get Hard;36301202;111811453;1000;Get Hard;59;71811453
1167;40000000;Romance Horror;Dracula;45022964;215862692;1280;Dracula;71;175862692
1168;40000000;Romance Drama;Julie & Julia;22853006;129540499;1230;Julie & Julia;66;89540499
1169;40000000;Drama;42;3,19E+15;95020213;1280;42;68;55020213
1170;40000000;Thriller Crime Drama;The Talented Mr. Ripley;31385257;128798265;1390;The Talented Mr. Ripley;70;88798265
1171;40000000;Comedy;Dumb and Dumber To;67767785;169837010;1100;Dumb and Dumber To;54;129837010
1172;40000000;Adventure Drama Family;Eight Below;24287306;120455994;1200;Eight Below;67;80455994
1173;35000000;Comedy;The Intern;53114573;194564672;1210;The Intern;71;159564672
1174;40000000;Action Comedy;Ride Along 2;2,51E+16;124827316;1020;Ride Along 2;61;84827316
1175;40000000;Action Adventure Drama History Romance;The Last of the Mohicans;3,78E+16;75505856;1120;The Last of the Mohicans;71;35505856
1176;40000000;Drama Music;Ray;2,17E+16;124731534;1520;Ray;72;84731534
1177;40000000;Action Thriller Crime;Sin City;66003433;158733820;1240;Sin City;72;118733820
1178;40000000;Drama Action Thriller Crime;Vantage Point;24862767;151161491;900;Vantage Point;62;111161491
1179;41000000;Comedy;I Love You, Man;25391899;91636986;1050;I Love You, Man;65;50636986
1180;40000000;Comedy Romance;Shallow Hal;2,99E+16;141069860;1140;Shallow Hal;57;101069860
1181;40000000;Drama Thriller History;JFK;2682041;205405498;1890;JFK;75;165405498
1182;40000000;Comedy Crime;Big Momma's House 2;1,76E+16;138259062;990;Big Momma's House 2;54;98259062
1183;57000000;Action Comedy Crime Romance;The Mexican;21021809;147845033;1230;The Mexican;58;90845033
1184;20000000;Comedy;17 Again;52571674;136267476;1020;17 Again;61;116267476
1185;40000000;Comedy Romance;The Other Woman;34519636;196781193;1090;The Other Woman;62;156781193
1186;40000000;Horror Mystery;The Final Destination;32478077;186167139;820;The Final Destination;54;146167139
1187;40000000;Thriller Drama;Bridge of Spies;4,84E+16;165478348;1410;Bridge of Spies;72;125478348
1188;40000000;Action Drama Thriller War;Behind Enemy Lines;2,40E+16;91753202;1060;Behind Enemy Lines;60;51753202
1189;40000000;Comedy;Get Him to the Greek;17869443;90029656;1090;Get Him to the Greek;59;50029656
1190;50000000;Drama Romance Comedy;Shall We Dance?;1,42E+16;170128460;1070;Shall We Dance?;59;120128460
1191;40000000;Comedy Adventure Fantasy Science Fiction Action;Small Soldiers;2,31E+16;54682547;1100;Small Soldiers;62;14682547
1192;40000000;Action Adventure Fantasy Horror Science Fiction;Spawn;1,98E+16;87840042;960;Spawn;50;47840042
1193;35000000;Action Adventure Drama Thriller;The Count of Monte Cristo;26595983;75395048;1310;The Count of Monte Cristo;73;40395048
1194;40000000;Crime Drama Thriller;The Lincoln Lawyer;26072228;85412898;1190;The Lincoln Lawyer;70;45412898
1195;30000000;Action Mystery Thriller;Unknown;38643914;130786397;1130;Unknown;65;100786397
1196;40000000;Drama Mystery Thriller;The Prestige;74440708;109676311;1300;The Prestige;80;69676311
1197;42000000;Comedy;Horrible Bosses 2;82185281;107670357;1080;Horrible Bosses 2;61;65670357
1198;40000000;Animation Comedy Adventure Family Science Fiction;Escape from Planet Earth;1814218;74597643;890;Escape from Planet Earth;57;34597643
1199;40000000;Action Adventure Drama Thriller;Apocalypto;4,16E+16;120175290;1390;Apocalypto;73;80175290
1200;40000000;Action Adventure Thriller;The Living Daylights;23331459;191185897;1300;The Living Daylights;62;151185897
1201;40000000;Action Science Fiction Adventure Thriller;Predators;4,76E+16;126248813;1070;Predators;60;86248813
1202;0;Comedy Crime Drama Romance Thriller;Legal Eagles;7519433;0;1160;Legal Eagles;58;0
1203;40000000;Thriller Mystery;Secret Window;32908414;92913171;960;Secret Window;64;52913171
1204;40000000;Romance Drama Mystery;The Lake House;2,99E+16;114830111;990;The Lake House;65;74830111
1205;43000000;Drama Horror Mystery Thriller;The Skeleton Key;29105407;91974818;1040;The Skeleton Key;64;48974818
1206;0;Fantasy Drama Comedy Family;The Odd Life of Timothy Green;1,64E+16;51854875;1050;The Odd Life of Timothy Green;65;51854875
1207;40000000;Comedy Romance;Made of Honor;1,96E+16;84601681;1010;Made of Honor;60;44601681
1208;40000000;Music Drama;Jersey Boys;1,42E+16;67347013;1340;Jersey Boys;68;27347013
1209;40000000;Drama Crime Thriller;The Rainmaker;12229516;45916769;1350;The Rainmaker;67;5916769
1210;40000000;Horror Thriller;Gothika;27303608;141591324;980;Gothika;58;101591324
1211;36000000;Drama History Mystery;Amistad;3,70E+16;74000000;1550;Amistad;68;38000000
1212;40000000;Adventure;Medicine Man;7,02E+15;0;1060;Medicine Man;58;-40000000
1213;40000000;Fantasy Action Science Fiction Thriller Horror;Aliens vs Predator: Requiem;39381913;41797066;940;Aliens vs Predator: Requiem;49;1797066
1214;40000000;Comedy Family;Ri¢hie Ri¢h;14398356;0;950;Ri¢hie Ri¢h;54;-40000000
1215;65000000;Drama Romance;Autumn in New York;8680334;0;1030;Autumn in New York;57;-65000000
1216;40000000;Comedy Music Romance;Music and Lyrics;17659032;145896422;960;Music and Lyrics;62;105896422
1217;40000000;Adventure Comedy Science Fiction;Paul;43151268;97552050;1040;Paul;65;57552050
1218;40000000;Comedy;The Guilt Trip;15283444;41863726;950;The Guilt Trip;54;1863726
1219;40000000;Horror Mystery;Scream 4;3521926;97138686;1110;Scream 4;61;57138686
1220;40000000;Thriller Crime Mystery;8MM;25580272;96618699;1230;8MM;61;56618699
1221;38000000;Drama Music;The Doors;10794175;34416893;1400;The Doors;67;-3583107
1222;40000000;Comedy;Sex Tape;72641296;126069509;970;Sex Tape;53;86069509
1223;40000000;Comedy Drama;Hanging Up;3,42E+16;36037909;940;Hanging Up;50;-3962091
1224;47000000;Horror Mystery;Final Destination 5;38555482;157887643;920;Final Destination 5;59;110887643
1225;0;Comedy Crime Romance;Mickey Blue Eyes;6786117;0;1020;Mickey Blue Eyes;53;0
1226;40000000;Drama Romance;Pay It Forward;24313684;55707411;1220;Pay It Forward;70;15707411
1227;30000000;Comedy Drama Romance;Fever Pitch;9965073;50451307;1030;Fever Pitch;59;20451307
1228;40000000;Comedy;Drillbit Taylor;15055732;0;1020;Drillbit Taylor;55;-40000000
1229;0;Comedy Western;A Million Ways to Die in the West;32808675;0;1160;A Million Ways to Die in the West;58;0
1230;25000000;Adventure Fantasy Action Thriller Science Fiction;The Shadow;8178203;48063435;1080;The Shadow;54;23063435
1231;40000000;Drama;Extremely Loud & Incredibly Close;31066874;55247881;1290;Extremely Loud & Incredibly Close;69;15247881
1232;40000000;Comedy Drama Romance;Morning Glory;22491388;58785180;1020;Morning Glory;61;18785180
1233;40000000;Drama;Get Rich or Die Tryin';12885985;46442528;1170;Get Rich or Die Tryin';63;6442528
1234;40000000;Crime Action Adventure;The Art of War;7832337;30199105;1170;The Art of War;56;-9800895
1235;40000000;Drama Romance;Rent;10433667;31670620;1350;Rent;67;-8329380
1236;40000000;Drama Horror Thriller Crime;Bless the Child;3,32E+16;0;1070;Bless the Child;49;-40000000
1237;75000000;Comedy;The Out-of-Towners;4842626;29000000;900;The Out-of-Towners;50;-46000000
1238;40000000;Fantasy Horror Science Fiction;The Island of Dr. Moreau;13210898;49627779;960;The Island of Dr. Moreau;46;9627779
1239;40000000;Action Adventure Drama;The Musketeer;3296933;27053815;1040;The Musketeer;52;-12946185
1240;35000000;Drama;The Other Boleyn Girl;22939557;0;1150;The Other Boleyn Girl;64;-35000000
1241;40000000;Drama Romance;Sweet November;19372805;65754228;1190;Sweet November;64;25754228
1242;40000000;Horror;The Reaping;1,34E+16;62771059;990;The Reaping;54;22771059
1243;500000;Drama Crime;Mean Streets;1,70E+16;3000000;1100;Mean Streets;72;2500000
1244;40000000;Comedy War;Renaissance Man;4516953;24332324;1280;Renaissance Man;59;-15667676
1245;40000000;Action Thriller Crime Drama;Colombiana;33785969;60965854;1080;Colombiana;65;20965854
1246;40000000;Fantasy Animation Drama Romance Family;Quest for Camelot;1,61E+16;38172500;860;Quest for Camelot;69;-1827500
1247;40000000;Crime Drama Mystery;City By The Sea;3,48E+16;22433915;1080;City By The Sea;57;-17566085
1248;0;Drama Romance;At First Sight;5,78E+16;0;1280;At First Sight;59;0
1249;40000000;Action;Torque;7,36E+16;46546197;840;Torque;47;6546197
1250;0;Drama Thriller;City Hall;3621837;0;1110;City Hall;60;0
1251;45000000;Drama;Showgirls;1,45E+16;20350754;1280;Showgirls;49;-24649246
1252;40000000;Drama History;Marie Antoinette;22364549;60474340;1230;Marie Antoinette;65;20474340
1253;40000000;Action Crime Drama Thriller;Kiss of Death;6,91E+15;0;1010;Kiss of Death;57;-40000000
1254;63600000;Action Drama Thriller Crime;Get Carter;4494788;19412993;1020;Get Carter;48;-44187007
1255;42000000;Thriller Drama;Lo imposible;47559928;180274123;1130;The Impossible;70;138274123
1256;55000000;Action Adventure Comedy;Ishtar;2410546;14375181;1070;Ishtar;42;-40624819
1257;40000000;Adventure Animation Comedy Family;Fantastic Mr. Fox;41258956;46471023;870;Fantastic Mr. Fox;75;6471023
1258;40000000;Comedy Drama Romance;Life or Something Like It;8,98E+15;16872671;1030;Life or Something Like It;57;-23127329
1259;40000000;Comedy Fantasy Science Fiction;Memoirs of an Invisible Man;7222985;14358033;990;Memoirs of an Invisible Man;57;-25641967
1260;10000000;Comedy Romance;Le fabuleux destin d'Amélie Poulain;73720244;173921954;1220;Amélie;78;163921954
1261;0;Comedy;New York Minute;100403;0;910;New York Minute;55;0
1262;60000000;Comedy;Alfie;15219263;13395939;1030;Alfie;56;-46604061
1263;40000000;Adventure Drama Romance;Big Miracle;8303696;24719215;1070;Big Miracle;66;-15280785
1264;38000000;Drama Mystery;The Deep End of the Ocean;4746085;28121100;1060;The Deep End of the Ocean;59;-9878900
1265;40000000;Horror Thriller;FearDotCom;6756886;18902015;1010;FearDotCom;32;-21097985
1266;40000000;Adventure Fantasy Action Thriller;Cirque du Freak: The Vampire's Assistant;16424807;28169671;1090;Cirque du Freak: The Vampire's Assistant;55;-11830329
1267;40000000;Action Comedy Thriller;Duplex;15590001;19322135;890;Duplex;59;-20677865
1268;0;Comedy Music;Soul Men;5483671;0;1030;Soul Men;63;0
1269;0;Action Drama Thriller;Raise the Titanic;1630541;0;1150;Raise the Titanic;52;0
1270;45000000;Action Science Fiction;Universal Soldier: The Return;1,46E+16;10667893;820;Universal Soldier: The Return;42;-34332107
1271;33000000;Action Horror Mystery Science Fiction Thriller;Pandorum;28353517;20645327;1080;Pandorum;65;-12354673
1272;40000000;Action Science Fiction Thriller;Impostor;9579975;0;1020;Impostor;61;-40000000
1273;40000000;Action Adventure Drama Thriller;Extreme Ops;2911819;10959475;930;Extreme Ops;50;-29040525
1274;0;Comedy Fantasy Science Fiction;Just Visiting;10844882;0;880;Just Visiting;48;0
1275;50000000;Science Fiction Thriller;Sunshine;51502884;32017803;1070;Sunshine;70;-17982197
1276;40000000;Drama Comedy;A Thousand Words;1,31E+16;22044277;910;A Thousand Words;60;-17955723
1277;40000000;Adventure Fantasy Animation Comedy Science Fiction;Delgo;4238482;0;940;Delgo;54;-40000000
1278;40000000;Action Drama Crime;The Gunman;26935458;13644292;1150;The Gunman;55;-26355708
1279;40000000;Adventure Action Family;Stormbreaker;16282962;23937870;930;Stormbreaker;51;-16062130
1280;20000000;Thriller Drama Mystery;Disturbia;31690456;117760134;1050;Disturbia;66;97760134
1281;20000000;Action Crime Thriller Drama;Hackers;17842246;7563728;1070;Hackers;62;-12436272
1282;0;Action Adventure Thriller Drama;The Hunting Party;8,05E+15;0;1010;The Hunting Party;66;0
1283;30000000;Comedy Drama;The Hudsucker Proxy;1,42E+16;0;1110;The Hudsucker Proxy;71;-30000000
1284;40000000;Action Drama History;投名狀;6884467;0;1260;The Warlords;63;-40000000
1285;25000000;Action History War;Nomad;8,21E+15;0;1120;Nomad: The Warrior;43;-25000000
1286;39200000;Action Science Fiction Drama;Snowpiercer;64238688;86758912;1260;Snowpiercer;67;47558912
1287;25000000;Adventure Animation Comedy Family Fantasy;Un monstre à Paris;17375562;0;900;A Monster in Paris;65;-25000000
1288;0;Action Comedy;The Last Shot;67698;0;900;The Last Shot;59;0
1289;15000000;Fantasy Action Thriller;The Crow;44690107;94000000;1020;The Crow;73;79000000
1290;40000000;Action Adventure War History;Baahubali: The Beginning;1,63E+16;100000000;1590;Baahubali: The Beginning;75;60000000
1291;39000000;Drama Romance Fantasy;The Time Traveler's Wife;3,75E+16;101229792;1070;The Time Traveler's Wife;67;62229792
1292;0;Comedy;Because I Said So;18678415;69485490;1020;Because I Said So;58;69485490
1293;39000000;Animation Comedy Family;Frankenweenie;2,79E+16;35287788;870;Frankenweenie;66;-3712212
1294;39000000;Science Fiction Action Adventure Thriller;Serenity;45388937;38869464;1190;Serenity;74;-130536
1295;39000000;Romance Drama;Against the Ropes;2817364;6614280;1060;Against the Ropes;45;-32385720
1296;39000000;Comedy Action Adventure Fantasy Science Fiction;Superman III;22164202;75850624;1250;Superman III;53;36850624
1297;40000000;Comedy;Grudge Match;21362949;44907260;1130;Grudge Match;60;4907260
1298;80341000;Adventure Drama Action;Chi bi;148375;127814609;1500;Red Cliff;71;47473609
1299;30000000;Comedy Romance;Sweet Home Alabama;18256028;180622424;1080;Sweet Home Alabama;60;150622424
1300;38000000;Comedy Romance;The Ugly Truth;2,23E+16;205298907;960;The Ugly Truth;64;167298907
1301;0;Comedy Family;Sgt. Bilko;5,42E+16;0;900;Sgt. Bilko;55;0
1302;38000000;Action Adventure Family;Spy Kids 2: The Island of Lost Dreams;24085144;119723358;1000;Spy Kids 2: The Island of Lost Dreams;53;81723358
1303;38000000;Science Fiction Action Adventure Thriller;Star Trek: Generations;1,48E+16;120000000;1180;Star Trek: Generations;64;82000000
1304;3860000;Action Drama History;一代宗師;1,99E+16;64076736;1300;The Grandmaster;63;60216736
1305;38000000;Drama Romance;Water for Elephants;16801218;114156230;1200;Water for Elephants;67;76156230
1306;40000000;Adventure Family Fantasy Animation;Dragon Nest: Warriors' Dawn;5057695;0;880;Dragon Nest: Warriors' Dawn;68;-40000000
1307;50000000;Drama;The Hurricane;20825781;73956241;1460;The Hurricane;72;23956241
1308;38000000;Drama Thriller;Enough;11500783;51801187;1140;Enough;62;13801187
1309;35000000;Crime Comedy Romance;Heartbreakers;13932203;0;1230;Heartbreakers;57;-35000000
1310;38000000;Action Comedy Family;Paul Blart: Mall Cop 2;41258487;107597242;940;Paul Blart: Mall Cop 2;50;69597242
1311;53000000;Drama Romance Thriller;Angel Eyes;6,45E+16;29700000;1020;Angel Eyes;56;-23300000
1312;38000000;Comedy;Joe Somebody;5257009;0;990;Joe Somebody;55;-38000000
1313;38000000;Horror Mystery Thriller;The Ninth Gate;30359164;58401898;1330;The Ninth Gate;63;20401898
1314;38000000;Drama Thriller;Extreme Measures;3,43E+16;17380126;1180;Extreme Measures;57;-20619874
1315;57000000;Music Drama Comedy;Rock Star;1160815;16991902;1050;Rock Star;60;-40008098
1316;10000000;Drama;Precious;18664624;47536959;1100;Precious;69;37536959
1317;38000000;Action Drama;White Squall;1,00E+16;10300000;1290;White Squall;63;-27700000
1318;15000000;Horror Mystery Science Fiction;The Thing;5,27E+16;19629760;1090;The Thing;78;4629760
1319;38000000;Science Fiction Action Thriller;Riddick;46630062;98337295;1190;Riddick;62;60337295
1320;37000000;Action Adventure Mystery Thriller;Switchback;4131546;6482195;1180;Switchback;58;-30517805
1321;0;Action Western;Texas Rangers;5641978;0;1100;Texas Rangers;54;0
1322;55000000;Adventure Family Fantasy;City of Ember;23465539;17869048;900;City of Ember;62;-37130952
1323;32000000;Drama;The Master;25682509;28258060;1370;The Master;70;-3741940
1324;38000000;Adventure Action Comedy Romance;Virgin Territory;6760922;5410749;930;Virgin Territory;43;-32589251
1325;40000000;Drama;The Express;3,88E+16;9793496;1300;The Express;71;-30206504
1326;38000000;Adventure Science Fiction;The 5th Wave;57889964;109906372;1120;The 5th Wave;56;71906372
1327;37000000;Drama;Creed;5,78E+16;173567581;1330;Creed;73;136567581
1328;37000000;Crime Drama Thriller;The Town;24218358;154026136;1250;The Town;70;117026136
1329;40000000;Romance Comedy Drama;What to Expect When You're Expecting;2,70E+16;79700000;1100;What to Expect When You're Expecting;58;39700000
1330;37000000;Comedy Drama;Burn After Reading;3,19E+16;163720069;960;Burn After Reading;65;126720069
1331;37000000;Adventure Comedy Family Fantasy;Nim's Island;14353279;100076342;960;Nim's Island;56;63076342
1332;38000000;Drama Action;Rush;3,30E+15;90247624;1230;Rush;77;52247624
1333;37000000;Drama;Magnolia;30993736;48451803;1880;Magnolia;75;11451803
1334;30000000;Action Comedy Crime;Cop Out;25825771;55583804;1070;Cop Out;53;25583804
1335;38000000;Comedy Romance;How to Be Single;4,61E+16;112343513;1100;How to Be Single;59;74343513
1336;37000000;Drama Family;Dolphin Tale;6,64E+15;95404397;1130;Dolphin Tale;67;58404397
1337;37000000;Adventure Fantasy Drama Romance;Twilight;127084938;392616625;1220;Twilight;58;355616625
1338;36000000;Drama Thriller Crime;John Q;27465433;102244770;1160;John Q;70;66244770
1339;65000000;Action Comedy Crime;Blue Streak;16865782;117758500;930;Blue Streak;61;52758500
1340;37000000;Comedy Crime;We're the Millers;100348805;269994119;1100;We're the Millers;68;232994119
1341;36500000;Action Fantasy Science Fiction Thriller;Obitaemyy Ostrov;2785832;21834845;1150;The Inhabited Island;53;-14665155
1342;36000000;Drama Action Thriller;Breakdown;9176339;50159144;950;Breakdown;66;14159144
1343;36000000;Adventure Action Thriller;Never Say Never Again;23380757;160000000;1340;Never Say Never Again;58;124000000
1344;36000000;Science Fiction Comedy Adventure;Hot Tub Time Machine;33926473;64572262;1010;Hot Tub Time Machine;60;28572262
1345;36000000;Family Drama;Dolphin Tale 2;6967857;52424533;1070;Dolphin Tale 2;67;16424533
1346;42000000;Thriller;Reindeer Games;11470135;32168970;1240;Reindeer Games;54;-9831030
1347;36000000;Action Drama;A Man Apart;19854932;44350926;1090;A Man Apart;58;8350926
1348;37000000;Drama Comedy Romance;Aloha;2,97E+16;26250020;1050;Aloha;52;-10749980
1349;0;History Drama;Ghosts of Mississippi;8102925;0;1300;Ghosts of Mississippi;62;0
1350;0;Drama Romance;Snow Falling on Cedars;279483;0;1270;Snow Falling on Cedars;63;0
1351;37000000;Drama Thriller Horror;The Rite;1,15E+16;96047633;1140;The Rite;58;59047633
1352;36000000;Thriller Science Fiction Mystery Romance;Gattaca;70398356;12532777;1060;Gattaca;75;-23467223
1353;36000000;Drama Comedy;Isn't She Great;1068453;3003296;950;Isn't She Great;46;-32996704
1354;37000000;Animation Family;Space Chimps;6,29E+15;63800345;810;Space Chimps;52;26800345
1355;0;Comedy;Head of State;3,46E+16;0;950;Head of State;53;0
1356;35000000;Comedy;The Hangover;8221166;459270619;1000;The Hangover;72;424270619
1357;36000000;Action Drama History;葉問3;19167377;156844753;1050;Ip Man 3;65;120844753
1358;33000000;Adventure Comedy Crime Science Fiction;Austin Powers: The Spy Who Shagged Me;18316151;310940086;950;Austin Powers: The Spy Who Shagged Me;62;277940086
1359;35000000;Fantasy Action;Batman;44104469;411348924;1260;Batman;70;376348924
1360;0;Drama;There Be Dragons;6,67E+15;0;1120;There Be Dragons;59;0
1361;35000000;Adventure Action Comedy Thriller Crime;Lethal Weapon 3;36172182;321731527;1180;Lethal Weapon 3;64;286731527
1362;29000000;Drama;The Blind Side;25767395;309208309;1290;The Blind Side;72;280208309
1363;35000000;Action Comedy Family Adventure;Spy Kids;21543389;147934180;880;Spy Kids;55;112934180
1364;35000000;Comedy Crime;Horrible Bosses;50309843;117000000;980;Horrible Bosses;65;82000000
1365;38000000;Drama Adventure Western;True Grit;4,93E+15;252276927;1100;True Grit;72;214276927
1366;35000000;Comedy Drama Romance;The Devil Wears Prada;8,39E+15;326551094;1090;The Devil Wears Prada;70;291551094
1367;35000000;Science Fiction Adventure Mystery;Star Trek: The Motion Picture;24616634;139000000;1320;Star Trek: The Motion Picture;62;104000000
1368;35000000;Comedy Crime;Identity Thief;34005726;173965010;1110;Identity Thief;56;138965010
1369;35000000;Crime Thriller;Cape Fear;27714043;182300000;1280;Cape Fear;70;147300000
1370;35000000;Drama Crime;21;4,51E+16;69823199;1230;21;65;34823199
1371;35000000;Comedy;Trainwreck;72774941;140795793;1250;Trainwreck;59;105795793
1372;35000000;Comedy Romance;Guess Who;374263;68915888;1050;Guess Who;55;33915888
1373;27000000;Drama Romance War;The English Patient;2,94E+16;231976425;1620;The English Patient;70;204976425
1374;35000000;Crime Drama Mystery Thriller;L.A. Confidential;24860326;126216940;1380;L.A. Confidential;77;91216940
1375;35000000;Adventure Comedy Family;Sky High;11041659;86369815;1000;Sky High;58;51369815
1376;35000000;Comedy Romance;In & Out;11897925;0;900;In & Out;63;-35000000
1377;35000000;Science Fiction Horror Action;Species;2,36E+16;113374103;1080;Species;55;78374103
1378;1800000;Horror;A Nightmare on Elm Street;38204158;25504513;910;A Nightmare on Elm Street;72;23704513
1379;33000000;Horror Science Fiction Thriller;The Cell;2,54E+16;104155843;1070;The Cell;60;71155843
1380;0;Action Adventure Drama;The Man in the Iron Mask;2898027;0;1320;The Man in the Iron Mask;63;0
1381;35000000;Drama;Secretariat;9525037;60251371;1230;Secretariat;68;25251371
1382;34000000;Adventure Animation Comedy Family;TMNT;1839217;95608995;900;TMNT;60;61608995
1383;32000000;Drama;Radio;9254647;52277485;1090;Radio;68;20277485
1384;35000000;Romance Comedy;Friends with Benefits;40526587;150483765;1090;Friends with Benefits;65;115483765
1385;35000000;Comedy;Neighbors 2: Sorority Rising;5,02E+16;108758521;910;Neighbors 2: Sorority Rising;56;73758521
1386;35000000;Comedy Drama History;Saving Mr. Banks;3,20E+16;112544580;1250;Saving Mr. Banks;73;77544580
1387;34000000;Drama History;Malcolm X;19822791;48169908;2020;Malcolm X;72;14169908
1388;35000000;Comedy;This Is 40;38429648;88058786;1340;This Is 40;56;53058786
1389;35000000;Comedy Family;Old Dogs;1,37E+16;92219310;880;Old Dogs;52;57219310
1390;35000000;Fantasy Action Adventure Science Fiction Thriller;Underworld: Rise of the Lycans;5,19E+16;91353501;920;Underworld: Rise of the Lycans;62;56353501
1391;35000000;Comedy;License to Wed;14503568;69307224;910;License to Wed;52;34307224
1392;0;Comedy;The Benchwarmers;674556;0;800;The Benchwarmers;52;0
1393;30000000;Comedy Romance;Must Love Dogs;11120167;58405313;980;Must Love Dogs;58;28405313
1394;35000000;Crime Drama Thriller;Donnie Brasco;40370442;41954997;1270;Donnie Brasco;74;6954997
1395;33000000;Horror Action Science Fiction;Resident Evil;40715623;102984862;1000;Resident Evil;64;69984862
1396;10700000;Horror;Poltergeist;36230204;122200000;1140;Poltergeist;70;111500000
1397;0;Comedy Crime Thriller;The Ladykillers;23666229;0;1040;The Ladykillers;60;0
1398;35000000;Action;Max Payne;25903237;85416905;1000;Max Payne;52;50416905
1399;40000000;Action Thriller Science Fiction;In Time;6,02E+16;173930596;1090;In Time;67;133930596
1400;35000000;Comedy Romance;The Back-Up Plan;1,84E+16;77477008;1060;The Back-Up Plan;57;42477008
1401;35000000;Comedy Drama Romance;Something Borrowed;14029012;59901913;1120;Something Borrowed;59;24901913
1402;0;Adventure Comedy Fantasy;Black Knight;1,59E+16;0;950;Black Knight;51;0
1403;35000000;Comedy Family;The Bad News Bears;6889633;35323292;1020;The Bad News Bears;69;323292
1404;35000000;Action Adventure Thriller;Street Fighter;19286099;99423521;1020;Street Fighter;41;64423521
1405;35000000;Drama War;The Pianist;5,06E+16;120072577;1500;The Pianist;80;85072577
1406;35000000;Drama History;The Nativity Story;3721272;0;1010;The Nativity Story;64;-35000000
1407;40000000;Horror;House of Wax;1,72E+16;68766121;1130;House of Wax;55;28766121
1408;27000000;Drama Romance;Closer;22636908;115505027;1040;Closer;67;88505027
1409;35000000;Drama Crime History;J. Edgar;28069419;84606030;1370;J. Edgar;60;49606030
1410;35000000;Horror Mystery Thriller;Mirrors;1,98E+16;72436439;1100;Mirrors;60;37436439
1411;35000000;Drama Fantasy Horror;Queen of the Damned;11644243;45479110;1010;Queen of the Damned;54;10479110
1412;35000000;Science Fiction Action Thriller;Predator 2;2,79E+16;57120318;1080;Predator 2;59;22120318
1413;35000000;Drama;Untraceable;12677505;32483410;1010;Untraceable;59;-2516590
1414;35000000;Comedy Romance;Blast from the Past;8737058;40263020;1120;Blast from the Past;63;5263020
1415;35000000;Science Fiction;Flash Gordon;12343507;27107960;1110;Flash Gordon;61;-7892040
1416;35000000;Comedy Romance;Jersey Girl;1,47E+16;36098382;1020;Jersey Girl;58;1098382
1417;45000000;Action Thriller Crime Mystery;Alex Cross;14513243;30353232;1010;Alex Cross;51;-14646768
1418;35000000;Crime Drama Mystery Thriller;Midnight in the Garden of Good and Evil;5525544;25105255;1550;Midnight in the Garden of Good and Evil;63;-9894745
1419;8900000;Crime Action Thriller;Heist;15079993;4100000;930;Heist;56;-4800000
1420;35000000;Comedy Fantasy;Nanny McPhee and the Big Bang;23835055;93246388;1090;Nanny McPhee and the Big Bang;60;58246388
1421;35000000;Crime History;Hoffa;5926966;0;1400;Hoffa;61;-35000000
1422;30000000;Drama Mystery Science Fiction Thriller;The X Files: I Want to Believe;25454549;68369434;1040;The X Files: I Want to Believe;55;38369434
1423;31000000;Family Fantasy Comedy;Ella Enchanted;2271592;27388767;960;Ella Enchanted;59;-3611233
1424;35000000;Drama;Concussion;35120736;50363790;1230;Concussion;70;15363790
1425;35000000;Thriller Action Mystery;Abduction;19893646;82087155;1060;Abduction;56;47087155
1426;35000000;Animation Family Adventure;Valiant;1,41E+16;19478106;760;Valiant;52;-15521894
1427;35000000;Comedy Drama;Wonder Boys;9,01E+15;0;1110;Wonder Boys;69;-35000000
1428;35000000;Action Comedy Science Fiction;Superhero Movie;19088655;25871834;850;Superhero Movie;49;-9128166
1429;56000000;Thriller Crime Drama;Broken City;29490057;19701164;1090;Broken City;57;-36298836
1430;35000000;Horror Comedy;Cursed;1,12E+16;19294901;970;Cursed;51;-15705099
1431;35000000;Crime Action Thriller;Premium Rush;17709888;31083599;910;Premium Rush;62;-3916401
1432;35000000;Action Comedy Crime;Hot Pursuit;18262017;51680201;870;Hot Pursuit;54;16680201
1433;35000000;War Adventure Drama Romance;The Four Feathers;1,01E+16;29882645;1320;The Four Feathers;65;-5117355
1434;35000000;Action Crime;Parker;28670477;46216641;1180;Parker;57;11216641
1435;31000000;Comedy Romance;Wimbledon;16736734;41512007;980;Wimbledon;60;10512007
1436;35000000;Comedy;Furry Vengeance;1,37E+16;39340177;920;Furry Vengeance;46;4340177
1437;30000000;Action Horror Thriller;Bait;9780588;0;930;Bait;53;-30000000
1438;27000000;Fantasy Action Adventure;Krull;9904881;16519460;1170;Krull;58;-10480540
1439;35000000;Action Adventure Drama History;Lions for Lambs;9789027;63215872;920;Lions for Lambs;60;28215872
1440;35000000;Action Adventure Drama Thriller;Flight of the Intruder;681729;0;1150;Flight of the Intruder;57;-35000000
1441;35000000;Comedy Music;Walk Hard: The Dewey Cox Story;1073522;18317151;960;Walk Hard: The Dewey Cox Story;66;-16682849
1442;0;Drama Romance;The Shipping News;111399;0;1110;The Shipping News;64;0
1443;35000000;Action Western;American Outlaws;6,73E+16;13678913;940;American Outlaws;57;-21321087
1444;35000000;Drama History Romance;The Young Victoria;1,63E+16;27409889;1050;The Young Victoria;70;-7590111
1445;40000000;Action Crime Mystery Thriller;Whiteout;1,48E+16;12206028;1010;Whiteout;53;-27793972
1446;32000000;Drama Fantasy;The Tree of Life;43862456;54674226;1390;The Tree of Life;65;22674226
1447;33000000;Action Adventure Thriller;Knock Off;2706207;0;910;Knock Off;47;-33000000
1448;35000000;Action Drama Thriller Crime;Sabotage;27903999;17508518;1100;Sabotage;55;-17491482
1449;35000000;Drama Fantasy Horror Mystery Romance;The Order;3746806;11560806;1020;The Order;48;-23439194
1450;20500000;Action Crime;Punisher: War Zone;1,71E+16;10089373;1020;Punisher: War Zone;56;-10410627
1451;35000000;Family Fantasy Comedy;Zoom;10304172;12506188;830;Zoom;49;-22493812
1452;35000000;Adventure Drama Thriller;The Walk;37335721;61181942;1230;The Walk;69;26181942
1453;0;Fantasy Family Action;Warriors of Virtue;9,12E+15;0;1030;Warriors of Virtue;47;0
1454;35000000;Comedy Drama Romance;A Good Year;1,68E+16;42064105;1180;A Good Year;65;7064105
1455;35000000;Drama;Radio Flyer;3,50E+16;4651977;1140;Radio Flyer;66;-30348023
1456;35000000;Action Crime Drama Thriller;Bound by Honor;9122828;0;1800;Bound by Honor;77;-35000000
1457;35000000;Action Crime Drama Mystery Thriller;Smilla's Sense of Snow;5419181;0;1210;Smilla's Sense of Snow;66;-35000000
1458;35000000;Thriller Crime Romance;Femme Fatale;907278;16838910;1140;Femme Fatale;62;-18161090
1459;35000000;Action History War;Lion of the Desert;2864979;0;1730;Lion of the Desert;74;-35000000
1460;35000000;War Adventure Drama Romance;Le Hussard sur le toit;2877488;15000000;1350;The Horseman on the Roof;67;-20000000
1461;38000000;Drama War Romance Western;Ride with the Devil;5516207;635096;1380;Ride with the Devil;66;-37364904
1462;0;Drama;Biutiful;13930763;25147786;1480;Biutiful;70;25147786
1463;35000000;Action Comedy Western Crime;Bandidas;2027704;10496317;930;Bandidas;58;-24503683
1464;0;Drama Crime;Black Water Transit;1,27E+16;0;1000;Black Water Transit;0;0
1465;34000000;Action Mystery Science Fiction Thriller;The Maze Runner;131815575;348319861;1130;The Maze Runner;70;314319861
1466;35000000;Comedy;Unfinished Business;1,68E+16;14431253;910;Unfinished Business;50;-20568747
1467;34000000;Drama Romance;The Age of Innocence;9133747;32255440;1390;The Age of Innocence;70;-1744560
1468;35000000;Drama Adventure Science Fiction Romance;The Fountain;24606012;15304890;960;The Fountain;68;-19695110
1469;70000000;Action Comedy Thriller;Chill Factor;3,28E+16;11263966;1010;Chill Factor;53;-58736034
1470;35000000;Action Crime Drama Thriller;Stolen;16830184;2106557;960;Stolen;51;-32893443
1471;41677699;Animation Family;崖の上のポニョ;3958676;187479518;1000;Ponyo;75;145801819
1472;34000000;Drama Romance;The Longest Ride;41946523;63013281;1280;The Longest Ride;73;29013281
1473;75000000;Drama Science Fiction Thriller;The Astronaut's Wife;20697556;19598588;1090;The Astronaut's Wife;54;-55401412
1474;34000000;Romance Drama Adventure;I Dreamed of Africa;1656695;0;1140;I Dreamed of Africa;53;-34000000
1475;35000000;Comedy Romance;Playing for Keeps;17932561;0;1060;Playing for Keeps;54;-35000000
1476;35000000;Drama History;Mandela: Long Walk to Freedom;1,55E+16;27330000;1410;Mandela: Long Walk to Freedom;65;-7670000
1477;32000000;Drama History;Reds;4,60E+16;40382659;1950;Reds;71;8382659
1478;40000000;Drama;A Few Good Men;4,04E+16;243240178;1380;A Few Good Men;71;203240178
1479;50000000;Action Crime Thriller;Exit Wounds;12601306;79958599;1010;Exit Wounds;53;29958599
1480;30000000;Crime Comedy;Big Momma's House;24389194;173959438;980;Big Momma's House;56;143959438
1481;34000000;Family Fantasy Animation Adventure;The House of Magic;12867326;0;850;Thunder and the House of Magic;63;-34000000
1482;30000000;Horror Action Thriller Science Fiction;The Darkest Hour;23328823;64626786;890;The Darkest Hour;48;34626786
1483;33000000;Music Drama Romance;Step Up Revolution;2,98E+16;140470746;990;Step Up Revolution;67;107470746
1484;33000000;Action Crime Horror Thriller;Snakes on a Plane;19642328;62022014;1050;Snakes on a Plane;51;29022014
1485;33000000;Mystery Thriller;The Watcher;7339908;0;960;The Watcher;49;-33000000
1486;33000000;Action Crime Drama;The Punisher;3,51E+16;54700105;1240;The Punisher;61;21700105
1487;30000000;Drama;Goal!: The Dream Begins;16541791;27610873;1180;Goal!: The Dream Begins;66;-2389127
1488;30000000;Action Crime Thriller;Safe;3192695;40346186;940;Safe;63;10346186
1489;33000000;Comedy Drama;Pushing Tin;9060642;0;1240;Pushing Tin;57;-33000000
1490;32350000;Adventure Action Science Fiction;Return of the Jedi;46509071;572700000;1350;Return of the Jedi;79;540350000
1491;30000000;Action Thriller Science Fiction;Doomsday;21538222;22211426;1080;Doomsday;58;-7788574
1492;32000000;Drama Romance;The Reader;33923786;113019290;1240;The Reader;72;81019290
1493;35000000;Comedy;Wanderlust;20908494;24159934;980;Wanderlust;53;-10840066
1494;32000000;Comedy Family Fantasy;Elf;16901954;173398518;970;Elf;64;141398518
1495;32000000;Drama Fantasy Romance Science Fiction;Phenomenon;15039407;152036382;1230;Phenomenon;62;120036382
1496;33000000;Adventure Comedy Family;Snow Dogs;13655735;0;990;Snow Dogs;53;-33000000
1497;0;Fantasy Comedy Drama;Scrooged;21620317;60328000;1010;Scrooged;67;60328000
1498;32000000;Comedy Family;Nacho Libre;14642055;80197993;920;Nacho Libre;56;48197993
1499;32500000;Comedy Romance;Bridesmaids;17107065;288383523;1250;Bridesmaids;65;255883523
1500;32000000;Action Comedy;This Is the End;3,82E+16;126041322;1070;This Is the End;63;94041322
1501;29000000;Horror;Stigmata;14993169;50041732;1030;Stigmata;60;21041732
1502;32000000;Drama;Men of Honor;24147269;48814909;1290;Men of Honor;70;16814909
1503;32000000;Action Crime Drama Thriller;Takers;1847242;69055695;1070;Takers;60;37055695
1504;35000000;Comedy;The Big Wedding;1,88E+16;21819348;900;The Big Wedding;57;-13180652
1505;32000000;Crime Comedy Action;Big Mommas: Like Father, Like Son;15901137;83615414;1070;Big Mommas: Like Father, Like Son;53;51615414
1506;32000000;Thriller Science Fiction Mystery;Source Code;5919888;147332697;930;Source Code;71;115332697
1507;32000000;Action Adventure Drama Thriller;Alive;1448851;36733909;1200;Alive;67;4733909
1508;30000000;Thriller Drama Mystery;The Number 23;23197408;77566815;1010;The Number 23;63;47566815
1509;33000000;Adventure Drama Family;The Young and Prodigious T.S. Spivet;10651202;9494789;1050;The Young and Prodigious T.S. Spivet;67;-23505211
1510;35000000;Action Comedy;1941;1,00E+16;31755742;1130;1941;56;-3244258
1511;0;Drama Family;Dreamer: Inspired By a True Story;6048743;0;1060;Dreamer: Inspired By a True Story;63;0
1512;32000000;Drama Thriller Crime;A History of Violence;34628738;60740827;960;A History of Violence;69;28740827
1513;32000000;Action Thriller Crime;Transporter 2;475612;85167639;870;Transporter 2;62;53167639
1514;32000000;Action Western;The Quick and the Dead;1,65E+16;18552460;1070;The Quick and the Dead;63;-13447540
1515;28000000;Action Comedy Romance Thriller;Laws of Attraction;6201404;30016165;900;Laws of Attraction;56;2016165
1516;32000000;Drama;Bringing Out the Dead;15560918;0;1210;Bringing Out the Dead;66;-32000000
1517;32000000;Action Science Fiction Thriller Crime;Repo Men;2,58E+16;18409891;1110;Repo Men;62;-13590109
1518;70000000;Fantasy Drama Horror Action Thriller;디워;4822033;53587404;900;Dragon Wars: D-War;40;-16412596
1519;32000000;Fantasy Comedy Family;Bogus;3379454;0;1100;Bogus;54;-32000000
1520;30000000;Comedy;The Incredible Burt Wonderstone;269385;27437881;1000;The Incredible Burt Wonderstone;53;-2562119
1521;32000000;Animation Comedy Family Music;Cats Don't Dance;4,10E+16;3566637;750;Cats Don't Dance;71;-28433363
1522;0;Drama;Cradle Will Rock;4901553;0;1320;Cradle Will Rock;72;0
1523;32000000;War Crime Drama Mystery Romance;The Good German;5347936;5914908;1080;The Good German;59;-26085092
1524;32000000;Adventure;George and the Dragon;4120549;0;930;George and the Dragon;50;-32000000
1525;31500000;Drama War;Apocalypse Now;49973462;89460381;1530;Apocalypse Now;80;57960381
1526;32000000;Comedy Drama Romance;Going the Distance;13611544;42045846;1020;Going the Distance;60;10045846
1527;0;Music Drama Family;Mr. Holland's Opus;6,78E+16;106269971;1370;Mr. Holland's Opus;69;106269971
1528;31500000;Action;Criminal;27891012;14708696;1130;Criminal;57;-16791304
1529;31000000;Drama;Out of Africa;13864975;128499205;1610;Out of Africa;70;97499205
1530;31000000;Drama;Flight;42213765;161772375;1380;Flight;65;130772375
1531;34000000;Action Adventure Thriller Science Fiction;Moonraker;2,99E+16;210308099;1260;Moonraker;59;176308099
1532;30000000;Comedy Drama;The Grand Budapest Hotel;74417456;174600318;990;The Grand Budapest Hotel;80;144600318
1533;31000000;Drama Mystery;Hearts in Atlantis;706762;24185781;1010;Hearts in Atlantis;64;-6814219
1534;31000000;Comedy Horror;Arachnophobia;1,59E+16;53208180;1030;Arachnophobia;62;22208180
1535;31000000;Crime Drama Science Fiction Thriller;Frequency;19258041;68106245;1180;Frequency;70;37106245
1536;31000000;Comedy;Vacation;47753598;104384188;990;Vacation;62;73384188
1537;30250000;Comedy Thriller Crime;Get Shorty;15585138;115101622;1050;Get Shorty;64;84851622
1538;45000000;Action Comedy Crime Drama Music;Chicago;32217425;306776732;1130;Chicago;69;261776732
1539;34200000;Comedy Drama;Big Daddy;3,49E+16;234801895;930;Big Daddy;61;200601895
1540;30000000;Comedy Romance;American Pie 2;36432598;287553595;1080;American Pie 2;60;257553595
1541;30000000;Animation Comedy Family;Toy Story;73640445;373554033;810;Toy Story;77;343554033
1542;30000000;Action Adventure Crime;Speed;49526736;350448145;1160;Speed;68;320448145
1543;30000000;Drama Romance;The Vow;2,68E+16;196114570;1040;The Vow;70;166114570
1544;31000000;Drama;Extraordinary Measures;6487344;15134293;1050;Extraordinary Measures;60;-15865707
1545;30000000;Drama;Remember the Titans;25996219;136706683;1130;Remember the Titans;74;106706683
1546;30000000;Action Adventure Thriller;The Hunt for Red October;4,62E+16;199200000;1340;The Hunt for Red October;72;169200000
1547;25000000;Drama;The Butler;32105328;115922175;1320;The Butler;72;90922175
1548;20000000;Comedy;DodgeBall: A True Underdog Story;41156217;167722310;920;DodgeBall: A True Underdog Story;62;147722310
1549;30000000;Horror Comedy Fantasy;The Addams Family;37179547;191502426;990;The Addams Family;67;161502426
1550;30000000;Crime Comedy Adventure;Ace Ventura: When Nature Calls;3,44E+16;212385533;900;Ace Ventura: When Nature Calls;61;182385533
1551;37000000;Comedy Family Romance;The Princess Diaries;40176265;165335153;1150;The Princess Diaries;65;128335153
1552;26000000;Comedy;The First Wives Club;10704596;116400000;1020;The First Wives Club;65;90400000
1553;33000000;Crime Mystery Thriller;Se7en;79579532;327311859;1270;Se7en;81;294311859
1554;30000000;Science Fiction;District 9;6313678;210819611;1120;District 9;73;180819611
1555;30000000;Animation Comedy Family;The SpongeBob SquarePants Movie;27870755;140161792;870;The SpongeBob SquarePants Movie;67;110161792
1556;25000000;Thriller Crime Drama Mystery;Mystic River;3,12E+16;156822020;1380;Mystic River;76;131822020
1557;30000000;Drama;Million Dollar Baby;70456012;216763646;1320;Million Dollar Baby;77;186763646
1558;80000000;Comedy Crime;Analyze This;2,94E+16;176885658;1030;Analyze This;64;96885658
1559;29000000;Romance Drama;The Notebook;55109138;115603229;1230;The Notebook;77;86603229
1560;30000000;Comedy Romance;27 Dresses;3,07E+16;160259319;1110;27 Dresses;61;130259319
1561;35000000;Comedy Drama Family Music Romance;Hannah Montana: The Movie;13788422;155545279;1020;Hannah Montana: The Movie;60;120545279
1562;30;Adventure Animation Comedy Family;Rugrats in Paris: The Movie;4,59E+16;103;780;Rugrats in Paris: The Movie;60;73
1563;30000000;Drama Romance;The Prince of Tides;3,85E+16;74787599;1320;The Prince of Tides;59;44787599
1564;30000000;Adventure Drama Romance War;Legends of the Fall;2,70E+15;160638883;1330;Legends of the Fall;72;130638883
1565;25000000;Drama Romance;Up in the Air;33704181;163670000;1090;Up in the Air;67;138670000
1566;30000000;Drama Comedy;About Schmidt;1,99E+16;105834556;1250;About Schmidt;67;75834556
1567;35000000;Horror Comedy Romance;Warm Bodies;43742241;116980662;970;Warm Bodies;64;81980662
1568;30000000;Action Thriller Science Fiction;Looper;46377628;47042000;1180;Looper;66;17042000
1569;0;Fantasy Comedy Science Fiction Romance;Down to Earth;9166658;0;870;Down to Earth;49;0
1570;30000000;Fantasy Drama Comedy Family;Babe;3436645;254134910;890;Babe;60;224134910
1571;30000000;Drama Comedy Romance;Hope Springs;12967137;114281051;1000;Hope Springs;58;84281051
1572;30000000;Comedy Romance Drama;Forgetting Sarah Marshall;50670253;105173115;1110;Forgetting Sarah Marshall;64;75173115
1573;45000000;Action Crime;Four Brothers;24694551;92374674;1090;Four Brothers;67;47374674
1574;30000000;Comedy;Baby Mama;11409124;63833449;990;Baby Mama;58;33833449
1575;0;Drama Romance;Hope Floats;7922716;0;1140;Hope Floats;58;0
1576;30000000;Comedy;Bride Wars;3,34E+16;114663461;890;Bride Wars;59;84663461
1577;19000000;Action Adventure Comedy Thriller;Without a Paddle;8584398;69631118;950;Without a Paddle;53;50631118
1578;37000000;Comedy Fantasy Romance;13 Going on 30;41569541;96455697;980;13 Going on 30;63;59455697
1579;30000000;Fantasy Comedy Romance;Midnight in Paris;43753585;151119219;940;Midnight in Paris;74;121119219
1580;0;Animation Comedy Family Adventure;The Nut Job;1,86E+16;0;850;The Nut Job;55;0
1581;53000000;Crime Drama;Blow;2,84E+16;83282296;1240;Blow;74;30282296
1582;80000000;Romance Drama;Message in a Bottle;1081051;118880016;1310;Message in a Bottle;58;38880016
1583;30000000;Science Fiction Action Adventure Thriller;Star Trek V: The Final Frontier;19578249;70200000;1070;Star Trek V: The Final Frontier;56;40200000
1584;30000000;Comedy Drama Family Fantasy;Like Mike;5,74E+16;0;990;Like Mike;57;-30000000
1585;30000000;Comedy Crime;The Naked Gun 33⅓: The Final Insult;28624038;51132598;830;The Naked Gun 33⅓: The Final Insult;63;21132598
1586;30000000;Adventure Action Thriller;A View to a Kill;27230493;152427960;1310;A View to a Kill;60;122427960
1587;30000000;Adventure Animation Comedy Family;The Curse of the Were-Rabbit;3,04E+16;192452832;850;The Curse of the Were-Rabbit;68;162452832
1588;30000000;Drama Romance;P.S. I Love You;2,95E+16;156835339;1260;P.S. I Love You;69;126835339
1589;30000000;Comedy;Racing Stripes;8058109;93772522;1020;Racing Stripes;51;63772522
1590;30000000;Drama Romance;Atonement;33369305;129266061;1230;Atonement;74;99266061
1591;30000000;Comedy Drama Romance;Letters to Juliet;1652083;0;1050;Letters to Juliet;66;-30000000
1592;30000000;Action Thriller Crime;Black Rain;1,12E+16;45892212;1250;Black Rain;62;15892212
1593;30000000;Comedy;The Three Stooges;14585968;54819301;920;The Three Stooges;49;24819301
1594;40000000;Romance Fantasy Animation Music;Corpse Bride;43571612;117195061;770;Corpse Bride;72;77195061
1595;0;Drama;Glory Road;8305085;42647449;1180;Glory Road;72;42647449
1596;30000000;Action Crime Drama Mystery Thriller;Sicario;55424027;84025816;1210;Sicario;72;54025816
1597;30000000;Action Drama;Southpaw;65364452;91709827;1230;Southpaw;73;61709827
1598;30000000;Horror Thriller;Drag Me to Hell;45083509;90810892;990;Drag Me to Hell;62;60810892
1599;25000000;Fantasy Drama Romance;The Age of Adaline;8,21E+15;65663276;1120;The Age of Adaline;74;40663276
1600;0;Comedy Drama Family;Secondhand Lions;15011624;0;1110;Secondhand Lions;69;0
1601;30000000;Drama Romance;Step Up 3D;2,51E+16;159291809;1070;Step Up 3D;66;129291809
1602;25000000;Adventure;Blue Crush;1142943;51842679;1040;Blue Crush;56;26842679
1603;30000000;Comedy Drama Fantasy Romance;Stranger Than Fiction;3226789;53653224;1130;Stranger Than Fiction;71;23653224
1604;30000000;Horror Thriller;30 Days of Night;33394082;75505973;1130;30 Days of Night;62;45505973
1605;30000000;Horror Thriller;The Cabin in the Woods;73987775;66486080;950;The Cabin in the Woods;65;36486080
1606;30000000;Comedy;Meet the Spartans;10608998;84646831;840;Meet the Spartans;37;54646831
1607;30000000;Adventure Comedy Crime;Midnight Run;1,28E+16;38413606;1260;Midnight Run;72;8413606
1608;27000000;Action Science Fiction;The Running Man;3,01E+16;38122105;1010;The Running Man;64;11122105
1609;25000000;Horror Comedy Music;Little Shop of Horrors;1,21E+16;38748395;940;Little Shop of Horrors;66;13748395
1610;30000000;Action Thriller Adventure;Hanna;31191975;63782078;1110;Hanna;65;33782078
1611;30000000;Action Fantasy Science Fiction;Mortal Kombat: Annihilation;11916389;51376861;950;Mortal Kombat: Annihilation;38;21376861
1612;30000000;Comedy Romance Drama;Larry Crowne;20355458;36160375;980;Larry Crowne;57;6160375
1613;30000000;Drama Horror;Carrie;6,38E+16;82394288;1000;Carrie;58;52394288
1614;30000000;Music;Take the Lead;8999675;34742066;1080;Take the Lead;66;4742066
1615;30000000;Action Adventure Crime Drama;Gridiron Gang;9278361;41480851;1250;Gridiron Gang;65;11480851
1616;45000000;Action Comedy;What's the Worst That Could Happen?;7185212;0;940;What's the Worst That Could Happen?;51;-45000000
1617;30000000;Action Adventure Animation Science Fiction Thriller;9;55806402;48428063;790;9;66;18428063
1618;30000000;Thriller Crime Drama;Side Effects;48237797;63372757;1060;Side Effects;64;33372757
1619;0;Comedy Romance;The Prince & Me;1,79E+16;0;1110;The Prince & Me;59;0
1620;30000000;Animation Family;Winnie the Pooh;19143721;14460000;630;Winnie the Pooh;68;-15540000
1621;19000000;Comedy;Dumb and Dumberer: When Harry Met Lloyd;1,57E+16;39267515;850;Dumb and Dumberer: When Harry Met Lloyd;41;20267515
1622;30000000;Comedy Drama;Bulworth;4,52E+15;29202884;1080;Bulworth;63;-797116
1623;0;Drama Music;Get on Up;13064264;31911598;1390;Get on Up;64;31911598
1624;0;Drama Romance;One True Thing;2644427;0;1270;One True Thing;62;0
1625;30000000;Action Crime Science Fiction Thriller;Virtuosity;5301589;24048000;1060;Virtuosity;54;-5952000
1626;0;Fantasy Drama Action Comedy Crime;My Super Ex-Girlfriend;20252143;60896147;950;My Super Ex-Girlfriend;48;60896147
1627;30000000;Thriller Crime Horror;Deliver Us from Evil;2,94E+16;0;1180;Deliver Us from Evil;59;-30000000
1628;30000000;Action Thriller;Sanctum;2,01E+16;108609310;1080;Sanctum;58;78609310
1629;35000000;Comedy Romance Drama;Little Black Book;6246199;22034832;1110;Little Black Book;52;-12965168
1630;30000000;Comedy;The Five-Year Engagement;2771063;53909751;1240;The Five-Year Engagement;57;23909751
1631;30000000;Comedy Drama;Mr. 3000;2850896;21800302;1040;Mr. 3000;50;-8199698
1632;30000000;Romance Drama Thriller Crime;The Next Three Days;3,44E+16;51148651;1330;The Next Three Days;69;21148651
1633;30000000;Science Fiction Action Thriller;Ultraviolet;1589534;31070211;870;Ultraviolet;48;1070211
1634;30000000;Thriller;Assault on Precinct 13;1,87E+16;35294470;1090;Assault on Precinct 13;60;5294470
1635;30000000;Action Drama Crime Thriller;The Replacement Killers;9607391;19204929;870;The Replacement Killers;60;-10795071
1636;25000000;Action Comedy Thriller;Fled;277255;17193231;980;Fled;52;-7806769
1637;0;Action Comedy Horror Thriller;Eight Legged Freaks;17834976;0;990;Eight Legged Freaks;54;0
1638;30000000;Drama Comedy Romance;Love & Other Drugs;20236951;102820008;1120;Love & Other Drugs;66;72820008
1639;30000000;Crime Mystery Thriller;88 Minutes;16883429;16930884;1080;88 Minutes;57;-13069116
1640;35000000;Drama;North Country;1,28E+16;25224242;1260;North Country;68;-9775758
1641;40000000;Comedy Thriller Crime;The Whole Ten Yards;1,47E+16;26155781;980;The Whole Ten Yards;55;-13844219
1642;26000000;Horror Thriller Science Fiction;Splice;23227877;0;1040;Splice;55;-26000000
1643;37000000;Comedy Fantasy Science Fiction;Howard the Duck;1,14E+16;37962774;1100;Howard the Duck;51;962774
1644;30000000;Thriller Crime Drama;Pride and Glory;10703602;31148328;1300;Pride and Glory;63;1148328
1645;30000000;Action Adventure Horror Thriller;The Cave;10756266;15007991;970;The Cave;51;-14992009
1646;30000000;Comedy Romance;Alex & Emma;4352422;15368897;960;Alex & Emma;50;-14631103
1647;30000000;Drama Mystery Romance Thriller;Wicker Park;9,30E+15;13001257;1140;Wicker Park;67;-16998743
1648;17000000;Horror Comedy;Fright Night;1827083;24922237;1060;Fright Night;60;7922237
1649;30000000;Drama History Romance;The New World;19106154;30536013;1350;The New World;64;536013
1650;30000000;Action Science Fiction;Wing Commander;5,26E+16;0;1000;Wing Commander;40;-30000000
1651;0;Drama Thriller;In Dreams;3226243;0;1000;In Dreams;54;0
1652;100000000;Action Adventure Fantasy Science Fiction Thriller;Dragonball Evolution;2,17E+16;0;850;Dragonball Evolution;29;-100000000
1653;30000000;Action Crime Thriller;The Last Stand;43882857;0;1070;The Last Stand;57;-30000000
1654;25000000;Drama Horror Science Fiction Thriller;Godsend;1210235;30114487;1020;Godsend;47;5114487
1655;23000000;Comedy Romance;Chasing Liberty;3,36E+16;12;1110;Chasing Liberty;61;-22999988
1656;30000000;Comedy Animation Family;Hoodwinked Too! Hood VS. Evil;10694417;13521829;860;Hoodwinked Too! Hood VS. Evil;48;-16478171
1657;30000000;Drama;An Unfinished Life;6353971;18618284;1080;An Unfinished Life;67;-11381716
1658;30000000;Adventure Fantasy Mystery;The Imaginarium of Doctor Parnassus;37181019;64352607;1230;The Imaginarium of Doctor Parnassus;63;34352607
1659;30000000;Comedy Drama;Barney's Version;4952735;8454301;1340;Barney's Version;72;-21545699
1660;30000000;Crime Thriller Drama;Runner Runner;22975918;62616646;910;Runner Runner;55;32616646
1661;30000000;Action Crime Drama;Antitrust;8,36E+15;18195610;1080;Antitrust;58;-11804390
1662;18000000;War;Glory;16102271;26828365;1220;Glory;74;8828365
1663;30000000;Drama Crime;Once Upon a Time in America;49336397;0;2290;Once Upon a Time in America;82;-30000000
1664;0;Thriller Action Crime Drama;Dead Man Down;29647844;18074539;1180;Dead Man Down;59;18074539
1665;0;Drama Romance;The Merchant of Venice;12467267;0;1380;The Merchant of Venice;67;0
1666;0;Crime Drama Thriller;The Good Thief;2774811;0;1080;The Good Thief;60;0
1667;0;Action Adventure Drama Romance;Supercross;371305;3102550;800;Supercross;54;3102550
1668;30000000;Drama Family Romance;Miss Potter;8,39E+15;35078241;920;Miss Potter;63;5078241
1669;0;Fantasy Drama Action Thriller Romance;Wu Ji;3866026;0;980;The Promise;50;0
1670;21000000;Adventure Action Thriller;DOA: Dead or Alive;12790408;480314;870;DOA: Dead or Alive;50;-20519686
1671;30000000;Action Drama Western;The Assassination of Jesse James by the Coward Robert Ford;3553352;14711793;1600;The Assassination of Jesse James by the Coward Robert Ford;70;-15288207
1672;30000000;Adventure Drama Action History War;辛亥革命;4065212;108348;1250;1911;50;-29891652
1673;0;Comedy;Le petit Nicolas;20362025;0;910;Little Nicholas;59;0
1674;30000000;Thriller Crime Drama;Wild Card;480343;0;920;Wild Card;54;-30000000
1675;30000000;Action Thriller Crime;Machine Gun Preacher;1,33E+16;2527904;1290;Machine Gun Preacher;64;-27472096
1676;0;Animation Family Comedy;Konferenz der Tiere;8010046;0;930;Animals United;55;0
1677;30000000;History Drama;Goodbye Bafana;1,23E+16;0;1400;Goodbye Bafana;70;-30000000
1678;27000000;Drama;United Passions;6,04E+16;0;1100;United Passions;30;-27000000
1679;30000000;Romance Drama;Grace of Monaco;10958697;0;1030;Grace of Monaco;58;-30000000
1680;30000000;Fantasy Adventure Animation;Савва. Сердце воина;2625594;0;850;Savva. Heart of the Warrior;64;-30000000
1681;30000000;Crime Thriller;Ripley's Game;2,98E+16;0;1100;Ripley's Game;66;-30000000
1682;19000000;Adventure Animation Comedy Fantasy;Sausage Party;66242737;140752617;830;Sausage Party;56;121752617
1683;29000000;Comedy Music;Pitch Perfect 2;71496894;287506194;1150;Pitch Perfect 2;68;258506194
1684;28000000;Drama Music Romance;Walk the Line;35580032;186438883;1360;Walk the Line;73;158438883
1685;30000000;Comedy;Keeping the Faith;8085872;37036004;1270;Keeping the Faith;59;7036004
1686;29000000;Adventure Fantasy Action Comedy Family;The Borrowers;10364582;0;860;The Borrowers;58;-29000000
1687;0;Drama History;Frost/Nixon;1687784;0;1220;Frost/Nixon;72;0
1688;30000000;Comedy Crime Drama Romance Thriller;Confessions of a Dangerous Mind;1,82E+16;33013805;1130;Confessions of a Dangerous Mind;66;3013805
1689;29000000;Comedy Romance;Serving Sara;893941;16930185;1000;Serving Sara;50;-12069815
1690;29000000;Comedy;The Boss;2055509;78636257;910;The Boss;55;49636257
1691;0;Drama;Cry Freedom;3735723;0;1570;Cry Freedom;69;0
1692;0;Comedy Drama Romance;Mumford;4310168;0;1120;Mumford;63;0
1693;12000000;Drama Horror Comedy;Seed of Chucky;12653831;24829644;870;Seed of Chucky;49;12829644
1694;29000000;Drama Mystery Thriller Fantasy;The Jacket;24240361;21126225;1030;The Jacket;68;-7873775
1695;28000000;Animation Family Comedy Adventure Fantasy;Aladdin;9,30E+15;504050219;900;Aladdin;74;476050219
1696;28000000;Drama Music;Straight Outta Compton;6,18E+15;201634991;1470;Straight Outta Compton;77;173634991
1697;28000000;Adventure Action;Indiana Jones and the Temple of Doom;66976776;333000000;1180;Indiana Jones and the Temple of Doom;71;305000000
1698;30000000;Animation Family;The Rugrats Movie;7981116;100491683;790;The Rugrats Movie;57;70491683
1699;60000000;Crime Mystery Thriller Action;Along Came a Spider;21252797;105178561;1040;Along Came a Spider;61;45178561
1700;29000000;Comedy Drama;Florence Foster Jenkins;19237254;48902953;1100;Florence Foster Jenkins;66;19902953
1701;29000000;Action;Once Upon a Time in Mexico;2,76E+15;98185582;1020;Once Upon a Time in Mexico;62;69185582
1702;28000000;Action Thriller;Die Hard;66169628;140767956;1310;Die Hard;75;112767956
1703;28000000;Comedy;Role Models;24917665;92380927;990;Role Models;64;64380927
1704;28000000;Comedy Drama;The Big Short;5,75E+16;133346506;1300;The Big Short;73;105346506
1705;0;Music Comedy Drama;Taking Woodstock;11870161;0;1200;Taking Woodstock;62;0
1706;28000000;Drama History;Miracle;7534003;64445708;1350;Miracle;70;36445708
1707;28000000;Fantasy Horror Action;Dawn of the Dead;44529429;102356381;1010;Dawn of the Dead;68;74356381
1708;35000000;Comedy;The Wedding Planner;14949395;94728529;1030;The Wedding Planner;55;59728529
1709;30000000;Animation Science Fiction;キャプテンハーロック;14726338;17137302;1150;Space Pirate Captain Harlock;65;-12862698
1710;21000000;Comedy Drama;The Royal Tenenbaums;2413081;71441250;1100;The Royal Tenenbaums;74;50441250
1711;30000000;Mystery Thriller;Identity;45915165;90259536;900;Identity;71;60259536
1712;28000000;Comedy;Last Vegas;2,80E+15;134402450;1050;Last Vegas;64;106402450
1713;28000000;Adventure Action Thriller;For Your Eyes Only;26090746;195312802;1270;For Your Eyes Only;63;167312802
1714;28000000;Comedy Romance;Serendipity;14530803;77516304;900;Serendipity;66;49516304
1715;27000000;Thriller Science Fiction Action Crime;Timecop;1,33E+16;101646581;990;Timecop;55;74646581
1716;28000000;Comedy;Zoolander;380958;60780981;890;Zoolander;61;32780981
1717;28000000;Romance;Safe Haven;37729059;97594140;1150;Safe Haven;69;69594140
1718;28000000;Comedy Family Fantasy;Hocus Pocus;18650748;39514713;960;Hocus Pocus;64;11514713
1719;28000000;Comedy;No Reservations;15794946;92601050;1040;No Reservations;61;64601050
1720;28000000;Action Crime;Kick-Ass;45054936;96188903;1170;Kick-Ass;71;68188903
1721;28000000;Action Adventure Comedy;30 Minutes or Less;2,50E+16;40547440;830;30 Minutes or Less;56;12547440
1722;28000000;Thriller Horror;Dracula 2000;6,76E+16;33000337;990;Dracula 2000;46;5000337
1723;28000000;Family Comedy;Alexander and the Terrible, Horrible, No Good, Very Bad Day;2214595;100654149;810;Alexander and the Terrible, Horrible, No Good, Very Bad Day;61;72654149
1724;28000000;Drama Romance;Pride & Prejudice;3658383;121147947;1350;Pride & Prejudice;77;93147947
1725;28000000;Science Fiction Drama Thriller;Blade Runner;9,41E+15;33139618;1170;Blade Runner;79;5139618
1726;28000000;Adventure;Rob Roy;10703456;31596911;1390;Rob Roy;65;3596911
1727;28000000;Action Drama Thriller Crime;3 Days to Kill;41638961;52597999;1130;3 Days to Kill;60;24597999
1728;21000000;Drama Crime Thriller;We Own the Night;1,45E+16;54926886;1170;We Own the Night;65;33926886
1729;0;Horror Thriller;Lost Souls;3312385;0;970;Lost Souls;45;0
1730;35866397;Documentary;Le peuple migrateur;375074;20217080;980;Winged Migration;70;-15649317
1731;28000000;Comedy Drama Family Fantasy Romance;Just My Luck;22074306;38159905;1030;Just My Luck;58;10159905
1732;28000000;Drama Comedy;Mystery, Alaska;4436792;8888143;1190;Mystery, Alaska;60;-19111857
1733;28000000;Action Comedy Family;The Spy Next Door;1,46E+16;45236543;940;The Spy Next Door;55;17236543
1734;28000000;Adventure Comedy Family Fantasy;A Simple Wish;1767479;8345056;860;A Simple Wish;55;-19654944
1735;28000000;Action Horror Science Fiction;Ghosts of Mars;1,31E+16;14010832;980;Ghosts of Mars;48;-13989168
1736;28000000;Comedy Drama;Our Brand Is Crisis;12921594;7002261;1080;Our Brand Is Crisis;58;-20997739
1737;28000000;Romance Horror Comedy Thriller;Pride and Prejudice and Zombies;2,84E+16;16374328;1080;Pride and Prejudice and Zombies;55;-11625672
1738;28000000;Drama;Kundun;7039189;5684789;1340;Kundun;68;-22315211
1739;27000000;Comedy Romance Drama;How to Lose Friends & Alienate People;16785866;17286299;1100;How to Lose Friends & Alienate People;62;-9713701
1740;28000000;Action Adventure Crime;Kick-Ass 2;4028635;60700000;1030;Kick-Ass 2;63;32700000
1741;24000000;Action;Alatriste;6,01E+16;23321954;1450;Alatriste;56;-678046
1742;28000000;Action Crime Drama;Brick Mansions;25520976;68896829;900;Brick Mansions;57;40896829
1743;27500000;Adventure Action Thriller;Octopussy;2,56E+16;187500000;1310;Octopussy;62;160000000
1744;30000000;Comedy Romance Drama;Knocked Up;2,25E+16;219076518;1290;Knocked Up;62;189076518
1745;30000000;Drama;My Sister's Keeper;2,41E+15;95714875;1090;My Sister's Keeper;71;65714875
1746;35000000;Comedy Drama;Welcome Home Roscoe Jenkins;6248273;43650785;1140;Welcome Home Roscoe Jenkins;57;8650785
1747;8000000;Drama Adventure History;A Passage to India;9548391;27187653;1630;A Passage to India;69;19187653
1748;15000000;Drama Romance;Notes on a Scandal;12576381;49469904;920;Notes on a Scandal;69;34469904
1749;27500000;Drama Thriller;Rendition;12741073;24748670;1200;Rendition;62;-2751330
1750;27000000;Science Fiction Action Adventure Thriller;Star Trek VI: The Undiscovered Country;16188572;96900000;1130;Star Trek VI: The Undiscovered Country;67;69900000
1751;27000000;Comedy Drama Romance;Divine Secrets of the Ya-Ya Sisterhood;5576937;0;1160;Divine Secrets of the Ya-Ya Sisterhood;56;-27000000
1752;27000000;Drama Mystery Thriller Crime;Kiss the Girls;18913;60527873;1150;Kiss the Girls;62;33527873
1753;27000000;Music Comedy Action Crime;The Blues Brothers;44714264;115229890;1330;The Blues Brothers;75;88229890
1754;27000000;Adventure Comedy Drama Family;The Sisterhood of the Traveling Pants 2;11870301;44352417;1170;The Sisterhood of the Traveling Pants 2;60;17352417
1755;0;Comedy Music;Joyful Noise;5753705;0;1170;Joyful Noise;67;0
1756;27000000;Drama Comedy Romance;About a Boy;2,82E+15;129000000;1010;About a Boy;66;102000000
1757;27000000;Horror Comedy Action Science Fiction Thriller;Lake Placid;11678561;56870414;820;Lake Placid;55;29870414
1758;27000000;Drama Thriller Crime Mystery;Lucky Number Slevin;36921445;56308881;1100;Lucky Number Slevin;74;29308881
1759;27000000;Drama History;The Right Stuff;17567332;21500000;1930;The Right Stuff;73;-5500000
1760;30000000;Drama History Thriller;Anonymous;1,67E+16;15395087;1300;Anonymous;63;-14604913
1761;27000000;Drama Family Fantasy Adventure;The Neverending Story;47862016;20158808;1020;The NeverEnding Story;70;-6841192
1762;27000000;Mystery Science Fiction;Dark City;39324831;27200316;1000;Dark City;72;200316
1763;0;Drama History Romance;The Duchess;18591657;0;1100;The Duchess;67;0
1764;25000000;Adventure Family Fantasy;Return to Oz;5650125;11137801;1090;Return to Oz;67;-13862199
1765;27000000;Crime Action Drama;The Newton Boys;3123583;76000000;1130;The Newton Boys;59;49000000
1766;27000000;Horror Mystery Thriller;Case 39;2,39E+16;29000000;1090;Case 39;61;2000000
1767;27000000;Crime Thriller;Suspect Zero;8715822;13000000;990;Suspect Zero;55;-14000000
1768;0;Drama;Martian Child;5737161;0;1060;Martian Child;68;0
1769;27000000;Family Comedy Action;Spy Kids: All the Time in the World;14788073;85564310;890;Spy Kids: All the Time in the World;44;58564310
1770;27000000;Thriller;Money Monster;38279458;93282604;980;Money Monster;65;66282604
1771;28;Thriller Action Comedy Crime;The 51st State;9670031;14;930;The 51st State;59;-14
1772;0;Comedy Drama;Flawless;5271559;4488529;1120;Flawless;59;4488529
1773;27000000;Mystery Thriller Crime;Mindhunters;17193659;21148829;1060;Mindhunters;63;-5851171
1774;25000000;Comedy Drama;What Just Happened;831653;6673422;1040;What Just Happened;52;-18326578
1775;0;Drama Thriller;The Statement;2653988;0;1200;The Statement;59;0
1776;0;Comedy Drama Music;The Magic Flute;548435;0;1330;The Magic Flute;69;0
1777;26000000;Action Adventure Comedy Family;Paul Blart: Mall Cop;3,13E+15;183293131;910;Paul Blart: Mall Cop;52;157293131
1778;26000000;Comedy;Freaky Friday;24345651;110230332;970;Freaky Friday;60;84230332
1779;26000000;Comedy Romance;The 40 Year Old Virgin;38473732;109449237;1160;The 40 Year Old Virgin;62;83449237
1780;25000000;Romance History;Shakespeare in Love;31792964;289317794;1220;Shakespeare in Love;68;264317794
1781;28000000;Crime Drama Mystery Thriller;A Walk Among the Tombstones;61309619;53181600;1130;A Walk Among the Tombstones;62;25181600
1782;15000000;Comedy;Kindergarten Cop;5411154;201957688;1110;Kindergarten Cop;58;186957688
1783;27000000;Action Comedy;Pineapple Express;41832392;101624843;1110;Pineapple Express;66;74624843
1784;26000000;Drama Romance Comedy;EverAfter;21988861;65705772;1210;Ever After: A Cinderella Story;68;39705772
1785;22000000;Western;Open Range;19068175;68296293;1390;Open Range;70;46296293
1786;26000000;Drama Horror Science Fiction Thriller;Flatliners;24114459;61489265;1150;Flatliners;63;35489265
1787;22000000;Drama History War;A Bridge Too Far;2,03E+16;50750000;1750;A Bridge Too Far;69;28750000
1788;26000000;Horror Thriller;Red Eye;8802626;57891803;850;Red Eye;62;31891803
1789;26000000;Horror Mystery;Final Destination 2;37355826;90426405;900;Final Destination 2;59;64426405
1790;26000000;Action Adventure Comedy;O Brother, Where Art Thou?;39742009;71868327;1060;O Brother, Where Art Thou?;73;45868327
1791;26000000;Horror;Legion;3,10E+16;67918658;1000;Legion;52;41918658
1792;25000000;Thriller Crime Action;Pain & Gain;31893932;86175291;1300;Pain & Gain;61;61175291
1793;0;Comedy Drama Romance;In Good Company;15376391;0;1090;In Good Company;59;0
1794;26000000;Adventure Family Science Fiction Thriller;Clockstoppers;5894163;38793283;940;Clockstoppers;49;12793283
1795;26000000;Action Crime Drama Western;Silverado;10981038;0;1270;Silverado;71;-26000000
1796;26000000;Drama Thriller War;Brothers;2207638;43318349;1040;Brothers;68;17318349
1797;26000000;Comedy;Agent Cody Banks 2: Destination London;10925618;28818995;1000;Agent Cody Banks 2: Destination London;52;2818995
1798;56000000;Comedy Romance;New Year's Eve;2,12E+16;142044638;1180;New Year's Eve;57;86044638
1799;42000000;Drama Thriller Mystery Romance;Original Sin;1,48E+16;35402320;1180;Original Sin;58;-6597680
1800;26000000;Crime Thriller Mystery;The Raven;2,25E+16;29657751;1110;The Raven;61;3657751
1801;30000000;Comedy;Welcome to Mooseport;3,31E+16;14000000;1100;Welcome to Mooseport;48;-16000000
1802;26000000;Action Fantasy Science Fiction;Highlander III: The Sorcerer;7,96E+15;36800000;990;Highlander: The Final Dimension;45;10800000
1803;26000000;Crime Drama Thriller;Blood and Wine;1492056;0;1010;Blood and Wine;55;-26000000
1804;26000000;Fantasy Horror;Snow White: A Tale of Terror;4810621;0;1000;Snow White: A Tale of Terror;60;-26000000
1805;0;Comedy Crime Mystery Romance Thriller;The Curse of the Jade Scorpion;9,32E+15;0;1030;The Curse of the Jade Scorpion;65;0
1806;26000000;Romance Comedy;Accidental Love;5644844;0;1000;Accidental Love;39;-26000000
1807;25530000;Adventure Family;Flipper;4475007;20080020;950;Flipper;53;-5449980
1808;26000000;Science Fiction Mystery Thriller;Self/less;66097437;30523226;1160;Self/less;63;4523226
1809;25000000;Drama Mystery Thriller;The Constant Gardener;2,07E+16;82466670;1290;The Constant Gardener;68;57466670
1810;30000000;Drama;The Passion of the Christ;38171417;611899420;1270;The Passion of the Christ;69;581899420
1811;25000000;Comedy Drama Family;Mrs. Doubtfire;3,09E+16;441286195;1250;Mrs. Doubtfire;70;416286195
1812;25000000;Drama;Rain Man;49510658;412800000;1330;Rain Man;76;387800000
1813;33000000;Drama;Gran Torino;507453;269958228;1160;Gran Torino;78;236958228
1814;25100000;Drama History;W.;10445391;29506464;1310;W.;61;4406464
1815;25000000;Action Thriller;Taken;80879032;226830568;930;Taken;72;201830568
1816;26000000;Drama Romance;The Best of Me;3393914;35926213;1170;The Best of Me;72;9926213
1817;25000000;Thriller Action Drama Music Romance;The Bodyguard;26576385;411006740;1290;The Bodyguard;61;386006740
1818;22000000;Drama History War;Schindler's List;104469351;321365567;1950;Schindler's List;83;299365567
1819;25000000;Drama;The Help;42191509;124272124;1460;The Help;78;99272124
1820;28000000;Drama Thriller;The Fifth Estate;20267062;8555008;1280;The Fifth Estate;57;-19444992
1821;0;Mystery Fantasy Adventure Comedy;Scooby-Doo 2: Monsters Unleashed;22644275;181466833;930;Scooby-Doo 2: Monsters Unleashed;54;181466833
1822;26000000;Thriller Adventure Mystery Fantasy;Viy;7182761;0;1270;Forbidden Kingdom;49;-26000000
1823;30000000;Horror;Freddy vs. Jason;2669592;114908830;970;Freddy vs. Jason;58;84908830
1824;0;Thriller Drama;The Face of an Angel;7336256;0;1000;The Face of an Angel;47;0
1825;25000000;Action Adventure Animation Comedy Family;Jimmy Neutron: Boy Genius;1,27E+16;80936232;830;Jimmy Neutron: Boy Genius;56;55936232
1826;25000000;Action Thriller Science Fiction;Cloverfield;46942396;170764026;850;Cloverfield;64;145764026
1827;25000000;Science Fiction Adventure Action Comedy Family;Teenage Mutant Ninja Turtles II: The Secret of the Ooze;15505137;78000000;880;Teenage Mutant Ninja Turtles II: The Secret of the Ooze;58;53000000
1828;25000000;Crime Drama History Thriller;The Untouchables;38272889;76270454;1190;The Untouchables;76;51270454
1829;25000000;Crime Drama Thriller;No Country for Old Men;5,36E+16;171600000;1220;No Country for Old Men;77;146600000
1830;25000000;Action Comedy;Ride Along;2,85E+16;153997819;990;Ride Along;61;128997819
1831;25000000;Comedy Romance Drama;Bridget Jones's Diary;35310712;281929795;970;Bridget Jones's Diary;65;256929795
1832;25000000;Comedy Drama Romance;Chocolat;28727731;152500343;1210;Chocolat;68;127500343
1833;45000000;Comedy;Legally Blonde 2: Red, White & Blonde;4,34E+15;124914842;950;Legally Blonde 2: Red, White & Blonde;51;79914842
1834;25000000;Comedy;Parental Guidance;1,46E+16;119772232;1040;Parental Guidance;57;94772232
1835;25000000;Comedy Romance;No Strings Attached;3,87E+16;147780440;1070;No Strings Attached;61;122780440
1836;25000000;Action Adventure Drama History Western;Tombstone;30537845;56505065;1300;Tombstone;74;31505065
1837;25000000;Action Crime Thriller;Romeo Must Die;19750059;91036760;1150;Romeo Must Die;60;66036760
1838;2800000;Horror Thriller;The Omen;25939385;60922980;1110;The Omen;72;58122980
1839;25000000;Horror Mystery;Final Destination 3;3164341;117719158;930;Final Destination 3;58;92719158
1840;25000000;Drama Romance;The Lucky One;26811541;99357138;1010;The Lucky One;68;74357138
1841;60000000;Adventure Drama Family;Bridge to Terabithia;40646102;137587063;960;Bridge to Terabithia;70;77587063
1842;25000000;Drama;Finding Neverland;3,42E+16;116766556;1060;Finding Neverland;72;91766556
1843;0;Comedy Drama;A Madea Christmas;5377155;0;1000;A Madea Christmas;70;0
1844;25000000;Action Drama Thriller;The Grey;48552871;77278331;1170;The Grey;64;52278331
1845;25000000;Horror Mystery Thriller;Hide and Seek;18228538;122644820;1010;Hide and Seek;61;97644820
1846;26000000;Comedy;Anchorman: The Legend of Ron Burgundy;29342744;90574188;940;Anchorman: The Legend of Ron Burgundy;67;64574188
1847;25000000;Drama Crime;GoodFellas;6,37E+15;46836394;1450;GoodFellas;82;21836394
1848;28000000;Action;Agent Cody Banks;11859396;58795814;1020;Agent Cody Banks;50;30795814
1849;25000000;Fantasy Comedy Family;Nanny McPhee;2,44E+16;122489822;970;Nanny McPhee;64;97489822
1850;25000000;Action Crime Drama Thriller;Scarface;70105981;65884703;1700;Scarface;80;40884703
1851;25000000;Action Adventure Comedy;Nothing to Lose;8,62E+15;0;970;Nothing to Lose;63;-25000000
1852;23000000;Drama History;The Last Emperor;21189028;43984230;1630;The Last Emperor;74;20984230
1853;25000000;Thriller Action Drama Crime;Contraband;31364901;63100000;1090;Contraband;61;38100000
1854;0;Action Adventure Comedy;Money Talks;7615653;0;970;Money Talks;59;0
1855;25000000;Drama;There Will Be Blood;3,78E+16;77208711;1580;There Will Be Blood;79;52208711
1856;35000000;Animation Adventure Family;The Wild Thornberrys Movie;5784661;0;850;The Wild Thornberrys Movie;58;-35000000
1857;0;Animation Family;Rugrats Go Wild;8255708;0;840;Rugrats Go Wild;56;0
1858;25000000;Action Comedy;Undercover Brother;6086083;41604473;860;Undercover Brother;55;16604473
1859;25000000;Drama Comedy;The Sisterhood of the Traveling Pants;1717372;39053061;1190;The Sisterhood of the Traveling Pants;63;14053061
1860;25000000;Action Crime Thriller;Kiss of the Dragon;1,69E+16;64437847;980;Kiss of the Dragon;64;39437847
1861;25000000;Romance Comedy;The House Bunny;25838073;70442940;970;The House Bunny;56;45442940
1862;25000000;Comedy Romance;Beauty Shop;5625632;36351350;1050;Beauty Shop;54;11351350
1863;25000000;Drama;Million Dollar Arm;17312433;38307627;1240;Million Dollar Arm;66;13307627
1864;25000000;Drama Science Fiction;The Giver;53811461;66980456;940;The Giver;64;41980456
1865;0;Comedy;What a Girl Wants;7057765;0;1050;What a Girl Wants;58;0
1866;17000000;Horror Thriller;Jeepers Creepers 2;19045146;63102666;1040;Jeepers Creepers 2;55;46102666
1867;25000000;Comedy Drama Romance;Good Luck Chuck;21729434;59192128;1010;Good Luck Chuck;55;34192128
1868;25000000;Action Crime Drama;Cradle 2 the Grave;12837116;56489558;1010;Cradle 2 the Grave;58;31489558
1869;25000000;Drama;The Hours;20953265;41597830;1140;The Hours;70;16597830
1870;20000000;Comedy Drama Family Romance;She's the Man;1081439;33889159;1050;She's the Man;64;13889159
1871;25000000;Family Comedy;Mr. Bean's Holiday;27683874;229736344;900;Mr. Bean's Holiday;61;204736344
1872;20000000;Adventure Action Horror Science Fiction Thriller;Anacondas: The Hunt for the Blood Orchid;9,86E+15;70992898;970;Anacondas: The Hunt for the Blood Orchid;49;50992898
1873;25500000;Thriller Crime Drama;Blood Ties;12756344;2415472;1280;Blood Ties;60;-23084528
1874;25000000;Drama;August Rush;29533437;66122026;1140;August Rush;71;41122026
1875;30000000;Drama History;Elizabeth;14179538;82150642;1240;Elizabeth;71;52150642
1876;25000000;Horror Comedy;Bride of Chucky;1,43E+16;50671850;890;Bride of Chucky;55;25671850
1877;25485000;History Action Drama Adventure War;Tora! Tora! Tora!;9795985;29548291;1440;Tora! Tora! Tora!;69;4063291
1878;25000000;Adventure Fantasy Drama Comedy Music;Spice World;6,89E+15;100000000;930;Spice World;47;75000000
1879;25000000;Comedy;The Sitter;19428994;34942188;810;The Sitter;54;9942188
1880;0;Action Comedy Music;Dance Flick;7326034;0;830;Dance Flick;47;0
1881;25000000;Drama Crime;The Shawshank Redemption;136747729;28341469;1420;The Shawshank Redemption;85;3341469
1882;21150000;Adventure Comedy;Crocodile Dundee in Los Angeles;6081772;39438674;920;Crocodile Dundee in Los Angeles;47;18288674
1883;27000000;Comedy;Kingpin;17329269;25023434;1130;Kingpin;67;-1976566
1884;25000000;Thriller Crime Drama;The Gambler;22622453;39171130;1110;The Gambler;57;14171130
1885;25000000;Comedy Drama;August: Osage County;20561682;74188937;1210;August: Osage County;69;49188937
1886;25000000;Drama Comedy Family;Ice Princess;13288177;27645491;980;Ice Princess;59;2645491
1887;30000000;Comedy;A Lot Like Love;19212552;42886719;1070;A Lot Like Love;65;12886719
1888;23000000;Comedy Drama History;Eddie the Eagle;29365851;46152800;1060;Eddie the Eagle;72;23152800
1889;25000000;Drama;He Got Game;10232599;21567853;1360;He Got Game;67;-3432147
1890;25000000;Romance Drama Comedy;Don Juan DeMarco;8870614;22200000;970;Don Juan DeMarco;62;-2800000
1891;25000000;Drama Romance War;Dear John;19402816;114977104;1150;Dear John;66;89977104
1892;25000000;Action Adventure Crime Mystery Thriller;The Losers;24903418;23580000;970;The Losers;62;-1420000
1893;25000000;Fantasy Horror Thriller;Don't Be Afraid of the Dark;14562197;36993168;990;Don't Be Afraid of the Dark;54;11993168
1894;25000000;Action Thriller Crime;War;18896239;40452643;1030;War;60;15452643
1895;25000000;Comedy Drama Romance;Punch-Drunk Love;1,60E+16;17000000;950;Punch-Drunk Love;69;-8000000
1896;25000000;Comedy;EuroTrip;25848003;20796847;930;EuroTrip;65;-4203153
1897;13000000;Crime Action Thriller;Half Past Dead;6337063;0;980;Half Past Dead;46;-13000000
1898;26000000;Comedy Family;Unaccompanied Minors;10006282;0;900;Unaccompanied Minors;54;-26000000
1899;0;Drama;Bright Lights, Big City;2753501;0;1070;Bright Lights, Big City;47;0
1900;0;Animation Family Fantasy;The Adventures of Pinocchio;6718497;0;900;The Adventures of Pinocchio;50;0
1901;25000000;Drama Family;The Greatest Game Ever Played;7,54E+15;15431177;1200;The Greatest Game Ever Played;69;-9568823
1902;30000000;Thriller Science Fiction;The Box;2,16E+15;33333531;1150;The Box;54;3333531
1903;8000000;Drama Horror;The Ruins;13715715;0;910;The Ruins;56;-8000000
1904;25000000;Comedy;The Next Best Thing;3,71E+16;24362772;1080;The Next Best Thing;43;-637228
1905;25000000;Drama Horror Mystery Thriller;My Soul to Take;7,00E+15;19829957;1070;My Soul to Take;52;-5170043
1906;25000000;Comedy;The Girl Next Door;3,98E+16;30411183;1080;The Girl Next Door;63;5411183
1907;25000000;Action Adventure Thriller;Maximum Risk;10115011;51702483;1000;Maximum Risk;52;26702483
1908;0;Action Comedy Drama;Stealing Harvard;7321181;0;850;Stealing Harvard;44;0
1909;25000000;Crime Thriller;Legend;32854557;42972994;1310;Legend;67;17972994
1910;0;Action Comedy;Hot Rod;6,31E+16;14334401;880;Hot Rod;63;14334401
1911;28000000;Horror Thriller;Shark Night;8363702;10126458;910;Shark Night;49;-17873542
1912;25;Drama;Angela's Ashes;488794;13;1450;Angela's Ashes;70;-12
1913;25000000;Drama;Draft Day;1417009;28831145;1090;Draft Day;65;3831145
1914;25000000;Fantasy Horror Science Fiction Thriller;Lifeforce;1218362;0;1160;Lifeforce;62;-25000000
1915;25000000;Crime Drama History;The Conspirator;9169271;15478800;1220;The Conspirator;62;-9521200
1916;25000000;Drama;Lords of Dogtown;8127728;13411957;1070;Lords of Dogtown;70;-11588043
1917;25000000;Drama History;The 33;10699952;24902723;1200;The 33;60;-97277
1918;25000000;Action Adventure Comedy Fantasy;Big Trouble in Little China;29796394;11000000;990;Big Trouble in Little China;71;-14000000
1919;0;Comedy Romance;Un Plan parfait;1,16E+16;0;1040;Fly Me to the Moon;56;0
1920;25000000;Action Drama;Warrior;51915025;23057115;1400;Warrior;77;-1942885
1921;28000000;Drama Thriller;Michael Collins;8314624;16900000;1320;Michael Collins;67;-11100000
1922;0;War Drama History;Gettysburg;5,53E+16;25000000;2540;Gettysburg;66;25000000
1923;25000000;Drama War;Stop-Loss;4002579;11207130;1130;Stop-Loss;61;-13792870
1924;25000000;Drama Mystery Thriller;Abandon;3888776;10719357;990;Abandon;46;-14280643
1925;25000000;Drama Thriller;Brokedown Palace;7296459;13000000;1000;Brokedown Palace;62;-12000000
1926;14000000;Horror Thriller;The Possession;21680424;85446075;920;The Possession;58;71446075
1927;25000000;Comedy Romance Drama;Mrs. Winterbourne;7,95E+16;10070000;1050;Mrs. Winterbourne;53;-14930000
1928;25000000;Drama Thriller;Straw Dogs;7473455;10324441;1100;Straw Dogs;55;-14675559
1929;25000000;Comedy Drama;The Hoax;5073536;11772461;1160;The Hoax;64;-13227539
1930;0;Action Crime Thriller;Stone Cold;3,62E+16;0;920;Stone Cold;57;0
1931;32000000;Adventure Drama;The Road;41075532;27635305;1110;The Road;68;-4364695
1932;25000000;Action Adventure Comedy Fantasy Science Fiction;Sheena;4020194;5778353;1170;Sheena;50;-19221647
1933;0;Action Comedy;Underclassman;2083856;0;950;Underclassman;55;0
1934;25000000;Comedy Romance;Say It Isn't So;2,91E+16;0;950;Say It Isn't So;48;-25000000
1935;25000000;Drama;The World's Fastest Indian;8450513;0;1270;The World's Fastest Indian;73;-25000000
1936;25000000;Action Comedy Fantasy Science Fiction;Tank Girl;8186936;4064495;980;Tank Girl;55;-20935505
1937;0;Comedy Crime;King's Ransom;5,08E+16;0;950;King's Ransom;51;0
1938;25000000;Drama Mystery Science Fiction Thriller;Blindness;1,76E+16;19844979;1210;Blindness;64;-5155021
1939;25000000;Action Adventure Fantasy Horror;BloodRayne;7008216;2405420;950;BloodRayne;35;-22594580
1940;25000000;Comedy Drama;Carnage;2,00E+16;27603069;800;Carnage;70;2603069
1941;25000000;Drama Mystery Thriller;Where the Truth Lies;4051221;0;1070;Where the Truth Lies;59;-25000000
1942;0;Fantasy Family;Cirque du Soleil: Worlds Away;5987486;34153101;910;Cirque du Soleil: Worlds Away;61;34153101
1943;25000000;Drama;Without Limits;3849873;777423;1170;Without Limits;62;-24222577
1944;25000000;Comedy Drama Romance;Me and Orson Welles;3593165;2336172;1140;Me and Orson Welles;66;-22663828
1945;13500000;Drama Romance Crime Mystery;La migliore offerta;30058263;19255873;1240;The Best Offer;77;5755873
1946;25000000;Drama Crime;The Bad Lieutenant: Port of Call - New Orleans;17339852;10589102;1220;The Bad Lieutenant: Port of Call - New Orleans;60;-14410898
1947;0;Animation Family;Sammy's avonturen: De geheime doorgang;15805449;0;880;A Turtle's Tale: Sammy's Adventures;56;0
1948;25000000;Comedy Drama;Les petits mouchoirs;1,53E+16;48531470;1540;Little White Lies;71;23531470
1949;0;Drama;Love Ranch;5000126;0;1170;Love Ranch;60;0
1950;0;Family Adventure Animation;La véritable histoire du Chat Botté;1684948;0;820;The True Story of Puss 'n Boots;38;0
1951;25000000;Family Animation;Белка и Стрелка. Звёздные собаки;5753564;6500000;850;Space Dogs;63;-18500000
1952;25000000;Thriller Crime Drama;The Counselor;3,50E+16;71009334;1170;The Counselor;50;46009334
1953;25000000;Romance Adventure Action History;Ironclad;1231708;0;1210;Ironclad;62;-25000000
1954;25000000;History Action Drama;Waterloo;1,89E+16;3052000;1280;Waterloo;70;-21948000
1955;25000000;Crime Action Thriller;一個人的武林;6,90E+16;0;1000;Kung Fu Jungle;65;-25000000
1956;25000000;Action Thriller;Red Sky;3344158;0;1000;Red Sky;41;-25000000
1957;14000000;Drama Romance;Dangerous Liaisons;14480628;34670720;1190;Dangerous Liaisons;70;20670720
1958;25000000;Adventure Drama;On the Road;14613152;8784318;1370;On the Road;55;-16215682
1959;24000000;Science Fiction Adventure;Star Trek IV: The Voyage Home;22258428;133000000;1190;Star Trek IV: The Voyage Home;69;109000000
1960;24000000;Drama;Rocky Balboa;30445257;155721132;1020;Rocky Balboa;65;131721132
1961;24000000;Horror Mystery;Scream 2;35244037;172363301;1200;Scream 2;61;148363301
1962;25000000;Action Drama Western;Jane Got a Gun;15333575;1397284;980;Jane Got a Gun;54;-23602716
1963;24000000;Comedy Romance;Think Like a Man Too;15237142;70181428;1050;Think Like a Man Too;64;46181428
1964;41300000;Comedy Crime;The Whole Nine Yards;23441135;106371651;980;The Whole Nine Yards;62;65071651
1965;8200000;Drama Family Music Romance;Footloose;2503414;80035402;1070;Footloose;64;71835402
1966;24000000;Comedy;Old School;2470166;87055349;910;Old School;66;63055349
1967;24000000;Comedy Drama;The Fisher King;16146572;41895491;1370;The Fisher King;72;17895491
1968;65000000;Horror Mystery Thriller;I Still Know What You Did Last Summer;20793026;40002112;1000;I Still Know What You Did Last Summer;51;-24997888
1969;24000000;Romance Comedy Drama;Return to Me;5771479;36609995;1150;Return to Me;61;12609995
1970;24000000;Comedy;Zack and Miri Make a Porno;2,73E+16;42105111;1020;Zack and Miri Make a Porno;61;18105111
1971;24000000;Comedy Crime Thriller;Nurse Betty;3572339;0;1080;Nurse Betty;59;-24000000
1972;24000000;Comedy War;The Men Who Stare at Goats;2069219;68729358;930;The Men Who Stare at Goats;59;44729358
1973;0;Adventure Drama Action Comedy Romance;Double Take;1903405;0;880;Double Take;55;0
1974;40000000;Drama;Girl, Interrupted;10713521;0;1270;Girl, Interrupted;76;-40000000
1975;17000000;Comedy Romance;Win a Date with Tad Hamilton!;7701041;16980098;950;Win a Date with Tad Hamilton!;55;-19902
1976;24000000;Fantasy Comedy Science Fiction Family;Muppets from Space;6,59E+15;16290976;870;Muppets from Space;58;-7709024
1977;24000000;Adventure Family Fantasy Music;The Wiz;2753313;21049053;1340;The Wiz;59;-2950947
1978;24000000;Action Comedy Drama;Ready to Rumble;3113009;12372410;1070;Ready to Rumble;47;-11627590
1979;24000000;Comedy Drama;Play It to the Bone;5566203;8434146;1240;Play It to the Bone;57;-15565854
1980;24000000;Romance Comedy;I Don't Know How She Does It;8630825;30551495;890;I Don't Know How She Does It;50;6551495
1981;24000000;Comedy Horror;Piranha 3D;2,33E+15;83188165;880;Piranha 3D;53;59188165
1982;23000000;Drama Music;Beyond the Sea;6,14E+16;0;1180;Beyond the Sea;65;-23000000
1983;24000000;Animation Comedy Family;Meet the Deedles;2353441;4562146;930;Meet the Deedles;41;-19437854
1984;28000000;Adventure Fantasy Animation Science Fiction Family;The Thief and the Cobbler;2439184;669276;720;The Thief and the Cobbler;68;-27330724
1985;0;Romance Drama;The Bridge of San Luis Rey;515677;0;1200;The Bridge of San Luis Rey;54;0
1986;24000000;Crime Drama Action Thriller;Faster;2,63E+16;23081726;980;Faster;61;-918274
1987;24000000;Fantasy Animation Adventure;ハウルの動く城;49549984;234710455;1190;Howl's Moving Castle;82;210710455
1988;23600000;Comedy Horror;Zombieland;57300674;102391382;880;Zombieland;72;78791382
1989;23000000;Comedy;The Waterboy;2,38E+16;185991646;900;The Waterboy;59;162991646
1990;18000000;Adventure Action Science Fiction;The Empire Strikes Back;7851783;538400000;1240;The Empire Strikes Back;82;520400000
1991;19000000;Action Comedy Crime Thriller;Bad Boys;33872182;141407024;1180;Bad Boys;65;122407024
1992;23000000;Comedy Crime;The Naked Gun 2½: The Smell of Fear;2,73E+16;86930411;850;The Naked Gun 2½: The Smell of Fear;66;63930411
1993;23000000;Horror;Final Destination;38799596;53302314;980;Final Destination;64;30302314
1994;12500000;Drama;The Ides of March;20317469;75993061;1010;The Ides of March;65;63493061
1995;23000000;Thriller Science Fiction Action;Pitch Black;18493202;53187659;1080;Pitch Black;67;30187659
1996;23000000;Comedy Romance;Someone Like You...;7901891;0;970;Someone Like You...;60;-23000000
1997;23000000;Romance Science Fiction Drama;Her;5,37E+16;47351251;1260;Her;79;24351251
1998;23000000;Mystery Thriller Drama;Joy Ride;11183197;36642838;970;Joy Ride;63;13642838
1999;25000000;Fantasy Adventure Family;The Adventurer: The Curse of the Midas Box;8842722;6399;990;The Adventurer: The Curse of the Midas Box;51;-24993601
2000;23000000;Drama Comedy Romance;Anywhere But Here;8,98E+15;18653615;1140;Anywhere But Here;59;-4346385
2001;0;Action Comedy;The Crew;2,63E+16;0;880;The Crew;64;0
2002;23000000;Action Thriller;Haywire;2,63E+16;33372606;930;Haywire;56;10372606
2003;23000000;Adventure Thriller;Jaws: The Revenge;12777008;51881013;890;Jaws: The Revenge;35;28881013
2004;0;Drama;Marvin's Room;6130231;0;980;Marvin's Room;66;0
2005;0;Drama Family;The Longshots;4030724;0;940;The Longshots;65;0
2006;23000000;Drama;The End of the Affair;6,92E+16;10827816;1020;The End of the Affair;66;-12172184
2007;23000000;Action Thriller;Harley Davidson and the Marlboro Man;12869436;7434726;980;Harley Davidson and the Marlboro Man;61;-15565274
2008;23000000;History Drama Thriller Crime Mystery;In the Valley of Elah;15676123;29541790;1240;In the Valley of Elah;66;6541790
2009;0;Drama History;Coco avant Chanel;8426589;0;1100;Coco Before Chanel;66;0
2010;11000000;Western Drama;Forsaken;11071522;0;900;Forsaken;58;-11000000
2011;23000000;Drama Comedy Romance;Chéri;5494047;9366227;860;Cheri;59;-13633773
2012;23000000;Drama Romance;Vanity Fair;6,62E+16;16123851;1410;Vanity Fair;55;-6876149
2013;23000000;Drama Action History;十月圍城;7876883;5837674;1390;Bodyguards and Assassins;65;-17162326
2014;25000000;Horror Thriller;1408;35169779;94679598;1040;1408;65;69679598
2015;22700000;Comedy Science Fiction;Spaceballs;39890798;38119483;960;Spaceballs;67;15419483
2016;22500000;War Drama;The Water Diviner;22096286;15520023;1120;The Water Diviner;68;-6979977
2017;22000000;Fantasy Drama Thriller Mystery Romance;Ghost;41967005;505000000;1270;Ghost;69;483000000
2018;23000000;Romance Comedy;There's Something About Mary;57110486;369884651;1190;There's Something About Mary;65;346884651
2019;22000000;Fantasy Drama Comedy Family;The Santa Clause;16234053;189833357;970;The Santa Clause;63;167833357
2020;20000000;Drama Family;The Rookie;11263361;75597042;1270;The Rookie;65;55597042
2021;22000000;Comedy Family;The Game Plan;20699212;147880543;1100;The Game Plan;60;125880543
2022;24000000;Drama Romance;The Bridges of Madison County;17606087;182016617;1350;The Bridges of Madison County;73;158016617
2023;22000000;Action Comedy;The Animal;13786075;84772742;840;The Animal;46;62772742
2024;22000000;Drama History;Gandhi;35227212;77737889;1910;Gandhi;74;55737889
2025;22000000;Drama;The Hundred-Foot Journey;27898438;88880821;1220;The Hundred-Foot Journey;73;66880821
2026;22000000;Crime Drama Mystery Thriller Action;The Net;23218144;110627965;1140;The Net;56;88627965
2027;22000000;Drama;I Am Sam;26071644;92542418;1320;I Am Sam;72;70542418
2028;22000000;Drama;Son of God;9,18E+15;67800064;1380;Son of God;59;45800064
2029;22000000;Fantasy Action Thriller;Underworld;81829237;95708457;1210;Underworld;66;73708457
2030;22000000;Drama Thriller;Derailed;177091;57479076;1080;Derailed;61;35479076
2031;22000000;Drama Comedy Crime;The Informant!;1,78E+16;35424826;1080;The Informant!;60;13424826
2032;22000000;Drama Romance;Shadowlands;5,61E+16;0;1310;Shadowlands;68;-22000000
2033;22000000;Comedy;Deuce Bigalow: European Gigolo;10259461;22400154;830;Deuce Bigalow: European Gigolo;47;400154
2034;26000000;Comedy;Delivery Man;30114383;51164106;1050;Delivery Man;62;25164106
2035;0;Thriller;Our Kind of Traitor;10547959;9930095;1080;Our Kind of Traitor;60;9930095
2036;22000000;Comedy Crime Romance;Saving Silverman;12887673;19351569;900;Saving Silverman;54;-2648431
2037;22000000;Comedy Family;Diary of a Wimpy Kid: Dog Days;13410919;77112176;940;Diary of a Wimpy Kid: Dog Days;60;55112176
2038;0;Thriller Drama Crime Romance;Summer of Sam;3,71E+16;0;1420;Summer of Sam;63;0
2039;22000000;Comedy;Jay and Silent Bob Strike Back;21865021;33788161;1040;Jay and Silent Bob Strike Back;64;11788161
2040;30000000;Drama Thriller;The Glass House;9,45E+15;23619609;1060;The Glass House;54;-6380391
2041;22000000;Comedy Drama Mystery;Hail, Caesar!;39006187;63647656;1060;Hail, Caesar!;57;41647656
2042;22000000;Comedy Music;Josie and the Pussycats;6404571;0;980;Josie and the Pussycats;53;-22000000
2043;22000000;Action Thriller;Homefront;35737655;43058898;1000;Homefront;64;21058898
2044;22000000;Family Horror;The Little Vampire;4365196;13555988;950;The Little Vampire;61;-8444012
2045;22000000;Comedy Romance;I Heart Huckabees;14925633;0;1060;I Heart Huckabees;62;-22000000
2046;22000000;Action Adventure Crime Science Fiction Thriller;RoboCop 3;1,47E+16;10696210;1040;RoboCop 3;42;-11303790
2047;0;Action Science Fiction Thriller;Megiddo: The Omega Code 2;809588;0;1040;Megiddo: The Omega Code 2;36;0
2048;0;Drama Comedy Thriller Music Romance;Darling Lili;816883;0;1070;Darling Lili;49;0
2049;70000000;Comedy Family Romance;Dudley Do-Right;8,79E+15;0;770;Dudley Do-Right;38;-70000000
2050;25000000;Thriller Action Crime;The Transporter Refueled;25002715;72629670;960;The Transporter Refueled;52;47629670
2051;0;Drama Romance;The Libertine;7588597;0;1140;The Libertine;59;0
2052;21000000;Drama Thriller War;Zwartboek;1,39E+16;26193068;1450;Black Book;72;5193068
2053;22000000;Romance Drama History War Music;Joyeux Noël;13960945;17709155;1160;Joyeux Noël;72;-4290845
2054;2000000;Action Comedy Romance;Hit & Run;16668854;14400000;1000;Hit & Run;55;12400000
2055;0;Action Comedy Crime;Mad Money;6847133;0;1040;Mad Money;59;0
2056;22000000;Mystery Thriller;Before I Go to Sleep;48784734;15447154;920;Before I Go to Sleep;62;-6552846
2057;22000000;Action Thriller Adventure;Sorcerer;9,09E+15;12000000;1210;Sorcerer;74;-10000000
2058;22000000;Drama;Stone;12445176;9479718;1050;Stone;52;-12520282
2059;0;Romance Drama Comedy;Molière;461335;0;1150;Moliere;67;0
2060;22000000;Thriller Drama Crime;Out of the Furnace;2,92E+16;15400000;1160;Out of the Furnace;65;-6600000
2061;25000000;Drama Mystery Crime;Michael Clayton;18961323;92991835;1190;Michael Clayton;65;67991835
2062;0;Comedy Drama;My Fellow Americans;2,81E+16;0;1010;My Fellow Americans;63;0
2063;21500000;Drama Thriller Mystery;Arlington Road;12819447;0;1170;Arlington Road;70;-21500000
2064;22000000;Animation Adventure Romance;Metegol;1,49E+16;24000000;1060;Underdogs;60;2000000
2065;17000000;Romance Comedy;To Rome with Love;1,50E+16;73244881;1110;To Rome with Love;56;56244881
2066;18000000;Science Fiction Action Adventure Thriller;Firefox;8700565;70687344;1360;Firefox;55;52687344
2067;21000000;Animation Comedy Music;South Park: Bigger, Longer & Uncut;27197799;0;810;South Park: Bigger, Longer & Uncut;71;-21000000
2068;9000000;Comedy Drama;Death at a Funeral;20410354;46;900;Death at a Funeral;69;-8999954
2069;21000000;Action Adventure Comedy Family Fantasy;Teenage Mutant Ninja Turtles III;10207065;42000000;960;Teenage Mutant Ninja Turtles III;51;21000000
2070;32000000;Comedy Romance;Hardball;5683281;40222729;1060;Hardball;63;8222729
2071;21000000;Drama Comedy Romance;Silver Linings Playbook;63599973;205738714;1220;Silver Linings Playbook;69;184738714
2072;21000000;Crime Drama;Freedom Writers;1,77E+16;41170784;1230;Freedom Writers;75;20170784
2073;0;Drama;For Colored Girls;1,93E+16;37000000;1340;For Colored Girls;70;37000000
2074;21000000;Action Crime Thriller;The Transporter;34433521;43928932;920;The Transporter;66;22928932
2075;20000000;Drama Action;Never Back Down;2621425;41627431;1150;Never Back Down;64;21627431
2076;21000000;Horror Thriller Science Fiction;The Rage: Carrie 2;4,78E+15;17762705;1040;The Rage: Carrie 2;51;-3237295
2077;17000000;Drama Comedy Romance;Away We Go;1,01E+16;14899417;980;Away We Go;67;-2100583
2078;21000000;Drama Comedy;Swing Vote;5815881;17600000;1200;Swing Vote;58;-3400000
2079;21000000;Romance Drama;Moonlight Mile;8982335;10011050;1170;Moonlight Mile;65;-10988950
2080;30000000;Drama Thriller Mystery;Tinker Tailor Soldier Spy;33649652;0;1270;Tinker Tailor Soldier Spy;66;-30000000
2081;0;Drama Comedy Romance;Molly;2636193;0;1020;Molly;55;0
2082;21000000;Drama;The Beaver;13847872;970816;910;The Beaver;63;-20029184
2083;35000000;Comedy;The Best Little Whorehouse in Texas;4189378;69701637;1140;The Best Little Whorehouse in Texas;59;34701637
2084;15000000;Action Thriller Science Fiction Horror;eXistenZ;21928025;2856712;970;eXistenZ;67;-12143288
2085;18000000;Adventure Action;Raiders of the Lost Ark;68159596;389925971;1150;Raiders of the Lost Ark;77;371925971
2086;18000000;Comedy Family Adventure Crime;Home Alone 2: Lost in New York;81487685;358991681;1200;Home Alone 2: Lost in New York;63;340991681
2087;20000000;Science Fiction Drama;Close Encounters of the Third Kind;5,25E+15;303788635;1350;Close Encounters of the Third Kind;72;283788635
2088;38000000;Horror Thriller;Pulse;9,66E+15;29907685;900;Pulse;50;-8092315
2089;20000000;Action Comedy Crime;Beverly Hills Cop II;2528436;299965036;1000;Beverly Hills Cop II;61;279965036
2090;20000000;Comedy;Bringing Down the House;8351385;132675402;1050;Bringing Down the House;54;112675402
2091;19000000;Crime Drama Thriller;The Silence of the Lambs;18174804;272742922;1190;The Silence of the Lambs;81;253742922
2092;20000000;Music Comedy;Wayne's World;21815122;121697323;940;Wayne's World;65;101697323
2093;20000000;Comedy Documentary Action;Jackass 3D;2099174;117224271;940;Jackass 3D;64;97224271
2094;20000000;Horror Thriller;Jaws 2;1,96E+16;187884007;1160;Jaws 2;59;167884007
2095;20000000;Adventure Comedy Family;Beverly Hills Chihuahua;1225264;149281606;910;Beverly Hills Chihuahua;49;129281606
2096;13000000;Horror Thriller;The Conjuring;49975409;318000141;1120;The Conjuring;74;305000141
2097;32000000;Adventure Comedy Family Romance;Are We There Yet?;13590677;97918663;950;Are We There Yet?;52;65918663
2098;20000000;Comedy;Tammy;21657563;100525432;970;Tammy;50;80525432
2099;35000000;Comedy Music;School of Rock;43057323;131282949;1080;School of Rock;67;96282949
2100;18000000;Action Fantasy;Mortal Kombat;1,65E+16;122195920;1010;Mortal Kombat;54;104195920
2101;37000000;Comedy;White Chicks;28703007;113086475;1090;White Chicks;63;76086475
2102;20000000;Comedy Drama;The Descendants;40903931;177243185;1150;The Descendants;67;157243185
2103;20000000;Adventure Family Drama Comedy;Holes;2,20E+16;0;1170;Holes;67;-20000000
2104;0;Drama Family Romance;The Last Song;23139971;0;1070;The Last Song;69;0
2105;20000000;Drama History;12 Years a Slave;959229;187000000;1340;12 Years a Slave;79;167000000
2106;20000000;Drama Romance Comedy Music;Drumline;4748929;57588485;1180;Drumline;62;37588485
2107;20000000;Comedy Romance;Why Did I Get Married Too?;2986286;60072596;1210;Why Did I Get Married Too?;61;40072596
2108;20000000;Fantasy Drama Romance;Edward Scissorhands;4751363;53000000;1050;Edward Scissorhands;75;33000000
2109;20000000;Drama Romance;Me Before You;5,32E+16;207945075;1100;Me Before You;76;187945075
2110;0;Drama Comedy Crime;Madea's Witness Protection;7,05E+16;0;1140;Madea's Witness Protection;59;0
2111;1800000;Action Crime Thriller;The French Connection;15978136;41158757;1040;The French Connection;74;39358757
2112;20000000;Comedy;Bad Moms;42512296;183936074;1000;Bad Moms;63;163936074
2113;20000000;Comedy;Date Movie;10098722;48548426;830;Date Movie;36;28548426
2114;20000000;Adventure Fantasy Animation Family;Return to Never Land;15341196;109862682;720;Return to Never Land;61;89862682
2115;20000000;History Drama;Selma;2,90E+16;66787908;1270;Selma;74;46787908
2116;20000000;Family Animation Adventure;The Jungle Book 2;19819893;135680000;720;The Jungle Book 2;56;115680000
2117;20000000;Thriller Horror Drama Mystery;Boogeyman;1162423;67192859;890;Boogeyman;46;47192859
2118;20000000;Thriller Drama Mystery;Premonition;22049787;84146832;960;Premonition;58;64146832
2119;30000000;Animation Family;The Tigger Movie;9,83E+15;45554533;770;The Tigger Movie;63;15554533
2120;20000000;Horror Thriller Mystery;Orphan;29295801;41596251;1230;Orphan;67;21596251
2121;20000000;Adventure Drama Family;Max;1,41E+16;43967255;1110;Max;68;23967255
2122;20000000;Action Adventure Comedy;Epic Movie;6,06E+16;86865564;860;Epic Movie;32;66865564
2123;20000000;Drama Thriller History;Spotlight;41503588;88346473;1280;Spotlight;78;68346473
2124;20000000;Drama Crime Thriller;Lakeview Terrace;20495749;27640028;1100;Lakeview Terrace;59;7640028
2125;20000000;Horror Thriller;The Grudge 2;1,39E+16;39143839;1020;The Grudge 2;52;19143839
2126;20000000;Comedy Drama Romance;How Stella Got Her Groove Back;2003047;37672350;1240;How Stella Got Her Groove Back;60;17672350
2127;0;Adventure Comedy Family Fantasy Science Fiction;Bill & Ted's Bogus Journey;11349664;0;980;Bill & Ted's Bogus Journey;59;0
2128;20000000;Comedy Drama Romance Thriller;Man of the Year;1,12E+16;41237648;1150;Man of the Year;58;21237648
2129;20000000;Adventure Family Science Fiction Action;The Black Hole;8265317;35841901;980;The Black Hole;61;15841901
2130;20000000;Crime Drama Thriller;The American;18632156;65464324;1040;The American;58;45464324
2131;20000000;Drama;Selena;692592;60000000;1270;Selena;70;40000000
2132;20000000;Horror Comedy;Vampires Suck;17165039;80547866;820;Vampires Suck;42;60547866
2133;25000000;Drama;Babel;25785925;135330182;1430;Babel;69;110330182
2134;19800000;Drama Comedy;This Is Where I Leave You;20311684;41296320;1030;This Is Where I Leave You;65;21496320
2135;20000000;Drama Mystery;Doubt;20975165;50907234;1040;Doubt;70;30907234
2136;32000000;Music Adventure Animation Action Comedy;Team America: World Police;26509175;50907422;980;Team America: World Police;66;18907422
2137;20000000;Horror Thriller;Texas Chainsaw 3D;26497025;47241945;920;Texas Chainsaw 3D;53;27241945
2138;0;Drama Thriller;Copycat;14211699;0;1240;Copycat;64;0
2139;20000000;Comedy;Scary Movie 5;36819044;78378744;860;Scary Movie 5;46;58378744
2140;20000000;Drama Action Comedy Western Music;Paint Your Wagon;7,90E+16;31678778;1580;Paint Your Wagon;62;11678778
2141;20000000;History Drama;Milk;30909699;54586584;1280;Milk;71;34586584
2142;20000000;Action;Risen;16663797;46069568;1070;Risen;57;26069568
2143;35000000;Horror Mystery Thriller;Ghost Ship;27724913;68349884;910;Ghost Ship;53;33349884
2144;19000000;Comedy;A Very Harold & Kumar Christmas;17971883;35387212;1080;A Very Harold & Kumar Christmas;60;16387212
2145;20000000;Crime Drama Mystery;Wild Things;25041992;67200000;1080;Wild Things;63;47200000
2146;0;Horror Thriller Mystery;The Stepfather;7924428;0;1010;The Stepfather;54;0
2147;20000000;Drama Thriller;The Debt;14857884;45636368;1130;The Debt;63;25636368
2148;30000000;Comedy Drama Romance Music;High Fidelity;23982956;47126295;1130;High Fidelity;70;17126295
2149;20000000;Horror Mystery Thriller;One Missed Call;12458131;0;870;One Missed Call;47;-20000000
2150;20000000;Drama Thriller;Eye for an Eye;4,00E+16;0;1010;Eye for an Eye;58;-20000000
2151;20000000;Thriller Crime Drama;The Bank Job;3,04E+16;64822796;1120;The Bank Job;66;44822796
2152;20000000;Science Fiction Drama Romance;Eternal Sunshine of the Spotless Mind;56481487;72258126;1080;Eternal Sunshine of the Spotless Mind;79;52258126
2153;20000000;Comedy Romance;You Again;19962713;32005248;1050;You Again;60;12005248
2154;20000000;Action Crime Drama Thriller;Street Kings;1,87E+16;65569869;1090;Street Kings;63;45569869
2155;20000000;Comedy Action Science Fiction;The World's End;5,60E+15;46089287;1090;The World's End;67;26089287
2156;0;Action Adventure Crime Family Mystery;Nancy Drew;50348;0;990;Nancy Drew;58;0
2157;20000000;Fantasy Horror Action Thriller Science Fiction;Daybreakers;28019226;51416464;980;Daybreakers;60;31416464
2158;20000000;Comedy Romance;She's Out of My League;16176976;49779728;1040;She's Out of My League;59;29779728
2159;20000000;Adventure Comedy Romance;Monte Carlo;17237143;17425000;1090;Monte Carlo;60;-2575000
2160;9000000;Horror Thriller;Stay Alive;434503;27105095;1000;Stay Alive;53;18105095
2161;0;Romance Action Adventure Western Drama;Quigley Down Under;11360997;0;1190;Quigley Down Under;65;0
2162;20000000;Family Animation;Alpha and Omega;12300789;39300000;880;Alpha and Omega;53;19300000
2163;20000000;Action Adventure Fantasy Horror Science Fiction;The Covenant;1,58E+16;37597471;970;The Covenant;52;17597471
2164;0;Comedy Drama;Stick It;9750557;0;1050;Stick It;63;0
2165;40000000;Comedy Family;Shorts;4100942;28972508;890;Shorts;51;-11027492
2166;20000000;Fantasy Drama Comedy Thriller;To Die For;1,23E+16;21284514;1060;To Die For;67;1284514
2167;20000000;Mystery Adventure Crime;Nerve;62933899;83707310;960;Nerve;71;63707310
2168;20000000;Drama Western Crime;Appaloosa;16074397;20211394;1150;Appaloosa;63;211394
2169;20000000;Action Drama Fantasy Horror Thriller;Vampires;17016284;0;1080;Vampires;58;-20000000
2170;806948;Drama Horror Thriller;Psycho;9,31E+15;32000000;1090;Psycho;82;31193052
2171;20000000;Romance Comedy;My Best Friend's Girl;17145287;36620508;1010;My Best Friend's Girl;54;16620508
2172;20000000;Drama Romance;Endless Love;27256849;34077920;1030;Endless Love;67;14077920
2173;20000000;Comedy Drama Romance;Georgia Rule;7878177;0;1130;Georgia Rule;56;-20000000
2174;20000000;Comedy;Under the Rainbow;173964;2297493;980;Under the Rainbow;49;-17702507
2175;20000000;Adventure Drama Fantasy Romance;Ladyhawke;1,44E+16;18432000;1210;Ladyhawke;68;-1568000
2176;20000000;Comedy Drama Family;Simon Birch;11090254;18253415;1140;Simon Birch;65;-1746585
2177;20000000;Drama;Reign Over Me;2,08E+16;22222308;1240;Reign Over Me;71;2222308
2178;15000000;Adventure Drama;Into the Wild;43644978;56255142;1480;Into the Wild;78;41255142
2179;20000000;Comedy Drama Romance;School for Scoundrels;8244324;17807569;1000;School for Scoundrels;56;-2192431
2180;20000000;Thriller Horror Mystery;Silent Hill: Revelation 3D;23292761;52302796;940;Silent Hill: Revelation 3D;50;32302796
2181;19000000;Horror Action Thriller Crime;From Dusk Till Dawn;64181668;25836616;1080;From Dusk Till Dawn;69;6836616
2182;0;Animation Family;Pooh's Heffalump Movie;903154;0;680;Pooh's Heffalump Movie;64;0
2183;0;Comedy Drama Romance;Home for the Holidays;4031585;17519169;1030;Home for the Holidays;63;17519169
2184;20000000;Action Comedy Crime Fantasy;功夫;1,37E+16;100914445;990;Kung Fu Hustle;72;80914445
2185;35000000;Adventure Comedy Family;The Country Bears;6908351;0;880;The Country Bears;43;-35000000
2186;20000000;Drama;The Kite Runner;10446722;73276047;1280;The Kite Runner;73;53276047
2187;20000000;Drama Crime Thriller;21 Grams;32243357;60427839;1240;21 Grams;72;40427839
2188;20000000;Action Drama Thriller;Paparazzi;9149089;16605763;840;Paparazzi;58;-3394237
2189;20000000;Comedy Romance;A Guy Thing;5596835;17432163;1010;A Guy Thing;53;-2567837
2190;0;Drama Comedy Romance Family;Loser;5,21E+16;0;980;Loser;50;0
2191;20000000;Documentary;Capitalism: A Love Story;1050098;17436509;1200;Capitalism: A Love Story;70;-2563491
2192;20000000;Drama History;The Greatest Story Ever Told;3011205;15473333;1990;The Greatest Story Ever Told;65;-4526667
2193;19500000;Crime Drama Mystery;Secret in Their Eyes;1,50E+16;34854990;1110;Secret in Their Eyes;62;15354990
2194;25000000;Action Comedy;Disaster Movie;16238961;14109284;870;Disaster Movie;30;-10890716
2195;20000000;Action Crime Drama Thriller;Armored;1521229;22942221;880;Armored;55;2942221
2196;20000000;Comedy Thriller Crime Action;The Man Who Knew Too Little;6397042;13801755;970;The Man Who Knew Too Little;65;-6198245
2197;20000000;Comedy Romance;What's Your Number?;19220789;30426096;1060;What's Your Number?;62;10426096
2198;20000000;Action Thriller Science Fiction;Lockout;35232278;32204030;950;Lockout;58;12204030
2199;40000000;Comedy;Envy;9842771;0;990;Envy;48;-40000000
2200;20000000;Action Thriller Crime;Crank: High Voltage;3,55E+15;34560577;960;Crank: High Voltage;59;14560577
2201;0;Action Comedy Thriller;Bullets Over Broadway;7829295;0;980;Bullets Over Broadway;70;0
2202;20000000;Drama;One Night with the King;3476925;13391174;1230;One Night with the King;61;-6608826
2203;30000000;Drama Action Thriller Romance;The Quiet American;5133744;27674124;1010;The Quiet American;64;-2325876
2204;20000000;Comedy Drama;The Weather Man;1,40E+16;12482775;1010;The Weather Man;60;-7517225
2205;20000000;Action Adventure Drama Thriller;Undisputed;17227376;12398628;960;Undisputed;61;-7601372
2206;0;Comedy Fantasy Romance;Ghost Town;1798817;0;1020;Ghost Town;64;0
2207;20000000;Action Adventure Drama Thriller;12 Rounds;1566135;17280326;1080;12 Rounds;57;-2719674
2208;20000000;Drama Horror Mystery;Let Me In;19705311;24145613;1160;Let Me In;67;4145613
2209;0;Adventure Action Comedy Family;3 Ninjas Kick Back;2645722;0;930;3 Ninjas Kick Back;45;0
2210;0;Drama Comedy;Be Kind Rewind;1,77E+16;0;1020;Be Kind Rewind;62;0
2211;0;Comedy Drama;Mrs Henderson Presents;2894154;0;1030;Mrs Henderson Presents;64;0
2212;20000000;Action Thriller;Triple 9;29371987;12639297;1150;Triple 9;56;-7360703
2213;20000000;Comedy Drama;Deconstructing Harry;1,14E+16;10686841;960;Deconstructing Harry;73;-9313159
2214;20000000;Comedy Romance;Three to Tango;7553773;0;980;Three to Tango;54;-20000000
2215;20000000;Drama;Burnt;30477114;36606743;1000;Burnt;63;16606743
2216;20000000;Comedy Crime Drama;We're No Angels;9,93E+15;0;1060;We're No Angels;56;-20000000
2217;20000000;Music Comedy Romance;Everyone Says I Love You;12379781;0;1010;Everyone Says I Love You;65;-20000000
2218;20000000;Action Crime Drama Thriller;Death Sentence;12643703;16974459;1050;Death Sentence;65;-3025541
2219;21000000;Drama;Everybody's Fine;15440465;0;990;Everybody's Fine;65;-21000000
2220;0;Comedy Family;Superbabies: Baby Geniuses 2;5886228;9109322;880;Superbabies: Baby Geniuses 2;19;9109322
2221;0;Action Comedy Crime;The Man;6,93E+15;12382362;830;The Man;54;12382362
2222;20000000;Action Comedy Crime;Code Name: The Cleaner;9,36E+15;10337477;840;Code Name: The Cleaner;47;-9662523
2223;20000000;Comedy;Connie and Carla;6102663;11341016;980;Connie and Carla;64;-8658984
2224;8000000;Comedy Drama Music Romance;Sweet Charity;7,09E+15;20000000;1490;Sweet Charity;65;12000000
2225;20000000;Comedy Romance Crime Drama Mystery;Inherent Vice;45742217;11110975;1480;Inherent Vice;65;-8889025
2226;0;Family;Doogal;1682839;0;850;Doogal;32;0
2227;20000000;Music Drama;Battle of the Year;8237336;16549477;1100;Battle of the Year;59;-3450523
2228;20000000;Comedy Fantasy;An American Carol;2,61E+16;7000000;830;An American Carol;41;-13000000
2229;12000000;Action Crime Thriller;Machete Kills;2,91E+16;15008161;1070;Machete Kills;53;3008161
2230;22000000;Horror;Willard;1,32E+16;0;1000;Willard;58;-22000000
2231;0;Comedy;Strange Wilderness;4,96E+16;6575282;870;Strange Wilderness;47;6575282
2232;0;Comedy Drama Music;Topsy-Turvy;8628519;0;1600;Topsy-Turvy;67;0
2233;20000000;Comedy Drama War;Little Boy;1,22E+16;6420319;1060;Little Boy;70;-13579681
2234;15000000;Drama Thriller;A Dangerous Method;2,71E+16;27462041;990;A Dangerous Method;62;12462041
2235;8700000;Animation Science Fiction Thriller;A Scanner Darkly;2,61E+16;7659918;1000;A Scanner Darkly;68;-1040082
2236;0;Drama;Chasing Mavericks;1,36E+16;0;1170;Chasing Mavericks;70;0
2237;20000000;Action Fantasy Horror Thriller;Alone in the Dark;9292987;10442808;960;Alone in the Dark;31;-9557192
2238;20000000;Comedy Drama Family Music;Bandslam;7716606;5210988;1110;Bandslam;54;-14789012
2239;20000000;Drama Mystery Thriller;Birth;7698075;0;1000;Birth;59;-20000000
2240;20000000;Crime Drama Thriller;A Most Violent Year;37629309;12007070;1250;A Most Violent Year;65;-7992930
2241;0;Drama Romance War History;Passchendaele;2405911;0;1140;Passchendaele;63;0
2242;0;Drama;Flash of Genius;3,35E+16;0;1190;Flash of Genius;63;0
2243;20000000;Drama Music;I'm Not There.;13032308;4001121;1350;I'm Not There.;66;-15998879
2244;20000000;Action Thriller;The Cold Light of Day;1,51E+16;16863583;930;The Cold Light of Day;48;-3136417
2245;20000000;Adventure Comedy Drama Romance;The Brothers Bloom;1,02E+16;5530764;1140;The Brothers Bloom;68;-14469236
2246;21000000;Drama;Synecdoche, New York;1,28E+16;0;1240;Synecdoche, New York;74;-21000000
2247;26500000;Adventure Fantasy Animation;もののけ姫;60732738;159375308;1340;Princess Mononoke;82;132875308
2248;0;Comedy Drama Foreign;Bon voyage;49446;0;1140;Bon voyage;57;0
2249;0;Comedy Music;Can't Stop the Music;6,57E+16;0;1240;Can't Stop the Music;49;0
2250;2000000;Action Adventure Crime Drama Thriller;The Proposition;14617944;5048693;1040;The Proposition;71;3048693
2251;20000000;Drama;My All American;3,10E+16;0;1180;My All American;68;-20000000
2252;20000000;Comedy;Marci X;565327;1675706;840;Marci X;33;-18324294
2253;20000000;Action Science Fiction Thriller;Equilibrium;44566609;5359645;1070;Equilibrium;69;-14640355
2254;40000000;Drama War;黃石的孩子;8978408;7400000;1250;The Children of Huang Shi;65;-32600000
2255;0;Drama Action Thriller Crime;The Yards;10150993;0;1150;The Yards;60;0
2256;0;Family;The Oogieloves in the Big Balloon Adventure;28576;0;880;The Oogieloves in the Big Balloon Adventure;22;0
2257;10000000;Drama Romance;By the Sea;11267676;3727746;1220;By the Sea;54;-6272254
2258;20000000;Animation Fantasy Science Fiction;Steamboy;9129808;0;1260;Steamboy;64;-20000000
2259;0;Drama;The Game of Their Lives;2013405;0;1010;The Game of Their Lives;58;0
2260;0;Drama Mystery Thriller Crime Romance;All Good Things;20086645;0;1010;All Good Things;59;0
2261;20000000;Adventure;Rapa Nui;3,58E+16;305070;1070;Rapa Nui;62;-19694930
2262;0;Comedy Drama Family Fantasy Science Fiction;長江七號;12373248;47301471;860;CJ7;61;47301471
2263;0;Comedy Fantasy;Les Visiteurs 2 : Les Couloirs du temps;12283025;0;1180;The Visitors II: The Corridors of Time;58;0
2264;20000000;Action Comedy Horror Mystery Science Fiction;Dylan Dog: Dead of Night;10617236;4634062;1070;Dylan Dog: Dead of Night;45;-15365938
2265;20000000;Drama Thriller;People I Know;6377308;0;1000;People I Know;55;-20000000
2266;20000000;Drama Fantasy;The Tempest;3620537;346594;1100;The Tempest;60;-19653406
2267;0;Horror Mystery Thriller;Regression;27215666;17671101;1060;Regression;53;17671101
2268;0;Action History Drama;三国之见龙卸甲;4127155;0;1020;Three Kingdoms: Resurrection of the Dragon;66;0
2269;20000000;Crime Drama Thriller;Butterfly on a Wheel;1,31E+16;0;950;Butterfly on a Wheel;63;-20000000
2270;20000000;Comedy Animation Adventure Family;Zambezia;14182301;0;830;Zambezia;53;-20000000
2271;0;Drama History;ராமானுஜன்;416179;0;1700;Ramanujan;50;0
2272;0;Animation;Dwegons;4,85E+16;0;980;Dwegons;5;0
2273;20000000;Drama;Hands of Stone;7444189;0;1050;Hands of Stone;61;-20000000
2274;20000000;Thriller;Survivor;3,36E+16;0;960;Survivor;54;-20000000
2275;27220000;Thriller Crime;The Frozen Ground;2,81E+16;5496951;1050;The Frozen Ground;61;-21723049
2276;19400000;Drama Romance;The Painted Veil;20746932;0;1250;The Painted Veil;71;-19400000
2277;27000000;Action Crime Drama History Thriller;Der Baader Meinhof Komplex;7,73E+15;0;1500;The Baader Meinhof Complex;71;-27000000
2278;22000000;Adventure Drama Western;Dances with Wolves;4,57E+16;424208848;1810;Dances with Wolves;76;402208848
2279;20000000;Comedy;Bad Teacher;28497242;216197492;920;Bad Teacher;54;196197492
2280;19000000;Drama Crime Mystery;Sea of Love;1147316;110879513;1130;Sea of Love;67;91879513
2281;19000000;Comedy;A Cinderella Story;2528132;70067909;950;A Cinderella Story;61;51067909
2282;14000000;Crime Horror Mystery;Scream;4,60E+16;173046663;1110;Scream;70;159046663
2283;0;Horror Thriller;Thir13en Ghosts;20392858;0;910;Thir13en Ghosts;54;0
2284;19000000;Horror Thriller;The Shining;78699993;44017374;1440;The Shining;81;25017374
2285;19000000;Adventure Comedy Science Fiction Family;Back to the Future;7,66E+15;381109762;1160;Back to the Future;80;362109762
2286;19000000;Horror Mystery Thriller;House on Haunted Hill;1,37E+16;40846082;930;House on Haunted Hill;55;21846082
2287;0;Drama Comedy;I Can Do Bad All By Myself;2242809;0;1130;I Can Do Bad All By Myself;60;0
2288;27000000;Action Drama;Fight Valley;1224105;0;900;Fight Valley;39;-27000000
2289;19000000;Comedy Romance Drama;The Switch;27494037;49830607;1010;The Switch;59;30830607
2290;18000000;Comedy;Just Married;1,85E+16;101564935;950;Just Married;53;83564935
2291;19100000;Drama Action Thriller Crime War;The Devil's Double;10559414;5728213;1090;The Devil's Double;65;-13371787
2292;0;Animation Drama Family Science Fiction;Thomas and the Magic Railroad;1916351;0;850;Thomas and the Magic Railroad;46;0
2293;20000000;Mystery Horror Action;The Crazies;28867568;54956140;1010;The Crazies;62;34956140
2294;15000000;Fantasy Adventure Animation Family;千と千尋の神隠し;118968562;274925095;1250;Spirited Away;83;259925095
2295;0;Action Crime;風暴;3,38E+16;0;1100;Firestorm;59;0
2296;25000000;Action Drama History;The Bounty;7436491;8613462;1320;The Bounty;65;-16386538
2297;0;Drama;The Book Thief;5784156;76586316;1310;The Book Thief;74;76586316
2298;19000000;Comedy Adventure Romance;Sex Drive;17952817;18755936;1090;Sex Drive;60;-244064
2299;19000000;Romance Comedy;Leap Year;2,20E+16;29922472;1000;Leap Year;64;10922472
2300;19000000;Drama History;The Fall of the Roman Empire;4,23E+15;4750000;1880;The Fall of the Roman Empire;60;-14250000
2301;19000000;Comedy Drama Romance;Take Me Home Tonight;11766564;6928068;970;Take Me Home Tonight;62;-12071932
2302;0;Drama;Won't Back Down;2,37E+16;5310554;1210;Won't Back Down;58;5310554
2303;19000000;Family Fantasy Music;The Nutcracker;68228;2119994;930;The Nutcracker;56;-16880006
2304;18000000;Thriller Drama Music Crime;Kansas City;5380733;0;1160;Kansas City;61;-18000000
2305;0;Drama;Indignation;5625989;0;1100;Indignation;68;0
2306;19000000;Horror Thriller Drama;The Amityville Horror;3,02E+16;108047131;900;The Amityville Horror;60;89047131
2307;19000000;Comedy Crime Drama;Adaptation.;26441669;32801173;1140;Adaptation.;73;13801173
2308;15000000;Horror;Land of the Dead;1,53E+16;46770602;930;Land of the Dead;60;31770602
2309;0;Action;逃出生天;1583918;0;1070;Out of Inferno;58;0
2310;18500000;Adventure Drama Comedy;Fear and Loathing in Las Vegas;44511363;10680275;1180;Fear and Loathing in Las Vegas;72;-7819725
2311;18500000;Comedy Romance Fantasy;The Invention of Lying;16665841;31912793;1000;The Invention of Lying;60;13412793
2312;18000000;Comedy;Neighbors;36471231;268157400;960;Neighbors;62;250157400
2313;23000000;Romance Comedy Crime Fantasy;The Mask;8530318;351583407;1010;The Mask;66;328583407
2314;18000000;Fantasy Drama Comedy Romance Family;Big;20716023;151668774;1040;Big;69;133668774
2315;18000000;Comedy;Borat: Cultural Learnings of America for Make Benefit Glorious Nation of Kazakhstan;29487784;261572744;820;Borat: Cultural Learnings of America for Make Benefit Glorious Nation of Kazakhstan;65;243572744
2316;18000000;Comedy;Legally Blonde;2543954;141774679;960;Legally Blonde;61;123774679
2317;18000000;Science Fiction Action Adventure Thriller;Star Trek III: The Search for Spock;15314027;87000000;1050;Star Trek III: The Search for Spock;64;69000000
2318;19000000;Crime Drama Horror Thriller;The Exorcism of Emily Rose;32602868;144216468;1220;The Exorcism of Emily Rose;63;125216468
2319;17000000;Comedy;Deuce Bigalow: Male Gigolo;9832326;65535067;880;Deuce Bigalow: Male Gigolo;55;48535067
2320;16000000;Thriller Action Science Fiction;Left Behind;33452469;19682924;1100;Left Behind;37;3682924
2321;0;Comedy Drama Romance;The Family Stone;14190837;0;1030;The Family Stone;62;0
2322;18000000;Comedy Drama;Barbershop 2:  Back in Business;6,50E+16;65070412;1060;Barbershop 2:  Back in Business;56;47070412
2323;23000000;Drama Comedy Crime;Bad Santa;2,66E+16;76488889;910;Bad Santa;65;53488889
2324;16500000;Science Fiction Comedy Crime;Austin Powers: International Man of Mystery;3615716;67683989;940;Austin Powers: International Man of Mystery;65;51183989
2325;18000000;Romance Comedy Family;My Big Fat Greek Wedding 2;16027955;88923251;940;My Big Fat Greek Wedding 2;55;70923251
2326;21000000;Family Comedy;Diary of a Wimpy Kid: Rodrick Rules;14329891;72417394;990;Diary of a Wimpy Kid: Rodrick Rules;63;51417394
2327;18000000;Science Fiction Action Adventure Thriller;Predator;50009408;98235548;1070;Predator;73;80235548
2328;18000000;Drama History Music;Amadeus;3182675;51973029;1600;Amadeus;78;33973029
2329;0;Crime Horror;Prom Night;9642041;14796236;880;Prom Night;48;14796236
2330;17000000;Comedy;Mean Girls;3,64E+16;129042871;970;Mean Girls;69;112042871
2331;0;Comedy Drama Romance;Under the Tuscan Sun;12309718;0;1130;Under the Tuscan Sun;64;0
2332;19800000;Drama Mystery Thriller;Gosford Park;11693272;87754044;1370;Gosford Park;68;67954044
2333;18000000;Comedy Drama Fantasy Romance;Peggy Sue Got Married;1,22E+16;41382841;1030;Peggy Sue Got Married;59;23382841
2334;18000000;Drama Comedy;Birdman;89811154;103215094;1190;Birdman;74;85215094
2335;18000000;Comedy Drama;Blue Jasmine;34694216;99206215;980;Blue Jasmine;70;81206215
2336;15000000;Drama History Crime Thriller Action;United 93;1,75E+16;76286096;1110;United 93;69;61286096
2337;18000000;Romance Music Family;Honey;18492655;62646763;940;Honey;60;44646763
2338;18000000;Action Comedy;Spy Hard;11238522;0;810;Spy Hard;49;-18000000
2339;1000000;Horror;The Fog;14518598;21378361;890;The Fog;64;20378361
2340;18000000;Action Drama;Soul Surfer;19234672;47088990;1060;Soul Surfer;69;29088990
2341;18000000;War Comedy Drama;Catch-22;4504377;24911670;1210;Catch-22;67;6911670
2342;0;Comedy Crime Drama;Observe and Report;10529143;24007324;860;Observe and Report;56;24007324
2343;18000000;Adventure Fantasy Action;Conan the Destroyer;1,84E+16;100000000;1030;Conan the Destroyer;58;82000000
2344;18000000;Drama;Raging Bull;35524457;23000000;1290;Raging Bull;77;5000000
2345;18000000;Drama Romance;Love Happens;13472365;36133014;1090;Love Happens;56;18133014
2346;18000000;Action Adventure Crime Drama Family;Young Sherlock Holmes;8321586;0;1090;Young Sherlock Holmes;67;-18000000
2347;0;Music Comedy Drama Romance;Fame;7668063;0;1070;Fame;55;0
2348;18000000;Adventure Drama Thriller;127 Hours;52464877;35692920;940;127 Hours;70;17692920
2349;0;Action Comedy Crime;Small Time Crooks;11423533;0;940;Small Time Crooks;64;0
2350;18000000;Drama Music;Center Stage;6961736;17200925;1150;Center Stage;68;-799075
2351;17000000;Comedy Family;Love the Coopers;9191187;24000000;1070;Love the Coopers;54;7000000
2352;18000000;Family Action Adventure;Catch That Kid;4,49E+15;16702864;920;Catch That Kid;49;-1297136
2353;18000000;Drama;Life as a House;5706767;0;1250;Life as a House;72;-18000000
2354;30000000;Drama History;Steve Jobs;53670525;34441873;1220;Steve Jobs;68;4441873
2355;18000000;Comedy Romance;I Love You, Beth Cooper;1415192;0;1020;I Love You, Beth Cooper;51;-18000000
2356;18000000;Drama Comedy Romance;Youth in Revolt;13462544;0;870;Youth in Revolt;59;-18000000
2357;18000000;Action Adventure Romance Western;The Legend of the Lone Ranger;1,17E+16;2945600;980;The Legend of the Lone Ranger;37;-15054400
2358;21000000;Drama Thriller;The Tailor of Panama;7047975;28008462;1090;The Tailor of Panama;62;7008462
2359;18000000;Drama Mystery Thriller;Blow Out;1,36E+16;12000000;1080;Blow Out;73;-6000000
2360;18000000;Action Crime;Getaway;16520516;10501938;900;Getaway;49;-7498062
2361;18000000;Drama;The Ice Storm;1,49E+16;8038061;1120;The Ice Storm;69;-9961939
2362;18000000;Comedy Drama Romance;And So It Goes;9633711;25312387;940;And So It Goes;57;7312387
2363;0;Adventure Comedy Family;Troop Beverly Hills;3455018;0;1050;Troop Beverly Hills;56;0
2364;0;Comedy Drama Romance;Being Julia;1946634;0;1040;Being Julia;64;0
2365;17000000;Drama Romance;Nine 1/2 Weeks;12313143;6735922;1170;Nine 1/2 Weeks;58;-10264078
2366;18000000;Fantasy;Dragonslayer;3258422;14110013;1080;Dragonslayer;65;-3889987
2367;0;Drama Romance;The Last Station;3,66E+16;0;1120;The Last Station;67;0
2368;18000000;Comedy Drama History;Ed Wood;24548633;5887457;1270;Ed Wood;73;-12112543
2369;18000000;Drama;Labor Day;17683563;20275812;1110;Labor Day;67;2275812
2370;18000000;History;Монгол;101449;26527510;1200;Mongol: The Rise of Genghis Khan;65;8527510
2371;18000000;Action Crime Thriller;RockNRolla;3,19E+16;25739015;1140;RockNRolla;69;7739015
2372;0;Adventure Action Science Fiction;Megaforce;1110179;0;990;Megaforce;35;0
2373;0;Drama;Hamlet;9814785;0;2420;Hamlet;73;0
2374;25000000;Drama Romance;Mao's Last Dancer;1876811;20719451;1170;Mao's Last Dancer;68;-4280549
2375;18000000;Adventure Drama Science Fiction;Midnight Special;3,27E+16;6212282;1120;Midnight Special;62;-11787718
2376;0;Comedy Romance;Anything Else;8945081;0;1080;Anything Else;62;0
2377;18000000;Drama History;The Railway Man;13916583;22309223;1160;The Railway Man;67;4309223
2378;15238800;Crime Drama Mystery;Das weisse Band;1794739;0;1440;The White Ribbon;72;-15238800
2379;0;Horror;Restoration;2525569;0;900;Restoration;53;0
2380;2700000;Romance Science Fiction Horror Action Crime;The Wraith;1047644;3500000;930;The Wraith;59;800000
2381;18000000;Drama Mystery Thriller;Salton Sea;1,10E+16;676698;1030;Salton Sea;70;-17323302
2382;18000000;Music;Metallica: Through the Never;7871686;7972967;930;Metallica: Through the Never;67;-10027033
2383;18000000;Drama;The Informers;6333869;382174;980;The Informers;44;-17617826
2384;18000000;Crime Drama Thriller History;Carlos;1138383;871279;3380;Carlos;67;-17128721
2385;18000000;Thriller Drama;I Come with the Rain;8,27E+15;0;1140;I Come with the Rain;56;-18000000
2386;0;Western Action Drama History;One Man's Hero;910529;0;1210;One Man's Hero;93;0
2387;3500000;Horror Science Fiction;Day of the Dead;18025206;34000000;960;Day of the Dead;69;30500000
2388;18000000;Action Crime Drama Thriller;I Am Wrath;1,01E+16;0;920;I Am Wrath;45;-18000000
2389;18000000;Action Animation Science Fiction;Renaissance;9244181;1831348;1050;Renaissance;67;-16168652
2390;17900000;Adventure Fantasy Action;Red Sonja;12752463;6948633;890;Red Sonja;50;-10951367
2391;14000000;Thriller;Red Lights;22748174;13551174;1190;Red Lights;60;-448826
2392;20000000;Comedy;Superbad;3,34E+16;121463226;1130;Superbad;70;101463226
2393;0;Comedy Crime Drama;Madea Goes to Jail;3107371;90508336;1030;Madea Goes to Jail;64;90508336
2394;18000000;Horror Action;Wolves;7922639;0;900;Wolves;57;-18000000
2395;23000000;Music Drama Romance;Step Up 2: The Streets;28973074;150816700;980;Step Up 2: The Streets;65;127816700
2396;15000000;Animation Comedy Family;Hoodwinked!;23980329;51053787;800;Hoodwinked!;59;36053787
2397;17500000;Drama History War;Hotel Rwanda;2,86E+16;38000000;1210;Hotel Rwanda;75;20500000
2398;24000000;Action Crime Drama Thriller;Hitman;42669304;99965753;890;Hitman;59;75965753
2399;17500000;Drama Music;Black Nativity;7180403;7018189;930;Black Nativity;58;-10481811
2400;18000000;Thriller Action;The Prince;21638673;266586800;930;The Prince;46;248586800
2401;0;Thriller;City of Ghosts;264486;0;1160;City of Ghosts;54;0
2402;0;Horror Drama Mystery Thriller;The Others;25881355;0;1010;The Others;74;0
2403;18500000;Horror Action Thriller Science Fiction;Aliens;6766094;183316455;1370;Aliens;77;164816455
2404;17000000;Drama Family Music Romance;My Fair Lady;20786616;72070731;1700;My Fair Lady;74;55070731
2405;17000000;Horror Thriller Mystery;I Know What You Did Last Summer;27654472;125586134;1000;I Know What You Did Last Summer;56;108586134
2406;17000000;Comedy;Let's Be Cops;7,07E+15;136621271;1040;Let's Be Cops;64;119621271
2407;16000000;Comedy Drama Romance;Sideways;23425431;109502303;1260;Sideways;69;93502303
2408;17500000;Comedy;Beerfest;14304444;19179969;1100;Beerfest;58;1679969
2409;300000;Horror Thriller;Halloween;30301307;70000000;910;Halloween;74;69700000
2410;17000000;Comedy Family Science Fiction;Good Boy!;3,56E+16;0;870;Good Boy!;47;-17000000
2411;17000000;Comedy;The Best Man Holiday;7210095;71625195;1230;The Best Man Holiday;67;54625195
2412;17000000;Action Comedy Crime Thriller;Smokin' Aces;23491962;57103895;1090;Smokin' Aces;64;40103895
2413;20000000;Horror Crime;Saw 3D;36133536;136150434;900;Saw: The Final Chapter;58;116150434
2414;17000000;Comedy Romance;40 Days and 40 Nights;1418136;0;940;40 Days and 40 Nights;52;-17000000
2415;17000000;Comedy;A Night at the Roxbury;12709227;30331165;810;A Night at the Roxbury;59;13331165
2416;17000000;Drama Fantasy Romance;Beastly;24054062;43165571;860;Beastly;60;26165571
2417;15000000;Horror Thriller;The Hills Have Eyes;35107857;69623713;1070;The Hills Have Eyes;61;54623713
2418;0;Comedy;Dickie Roberts: Former Child Star;10149569;0;980;Dickie Roberts: Former Child Star;51;0
2419;0;Drama;McFarland, USA;14023082;45710059;1280;McFarland, USA;74;45710059
2420;0;Comedy;Lottery Ticket;9054803;0;990;Lottery Ticket;56;0
2421;20000000;Drama;ATL;5422285;21170563;1050;ATL;60;1170563
2422;17000000;Comedy Music Romance;Pitch Perfect;32746486;115350426;1120;Pitch Perfect;73;98350426
2423;34000000;Drama Comedy Romance;Summer Catch;3,96E+16;19693891;1080;Summer Catch;48;-14306109
2424;0;Drama Crime Thriller;A Simple Plan;10178917;0;1210;A Simple Plan;69;0
2425;17000000;Horror Thriller;They;4,54E+16;0;890;They;46;-17000000
2426;0;Comedy;Larry the Cable Guy: Health Inspector;2184708;0;890;Larry the Cable Guy: Health Inspector;33;0
2427;0;Family;The Adventures of Elmo in Grouchland;309159;0;730;The Adventures of Elmo in Grouchland;63;0
2428;17000000;Crime Drama Thriller;Brooklyn's Finest;1,88E+16;29536299;1330;Brooklyn's Finest;62;12536299
2429;17000000;Action Drama History;55 Days at Peking;3,32E+16;10000000;1540;55 Days at Peking;63;-7000000
2430;17000000;Horror;Evil Dead;33912116;97542952;910;Evil Dead;64;80542952
2431;17000000;Comedy Romance;My Life in Ruins;5787891;20455276;950;My Life in Ruins;56;3455276
2432;17000000;Comedy Drama Family;American Dreamz;7864011;7314027;1070;American Dreamz;49;-9685973
2433;17000000;Action Adventure Science Fiction;Superman IV: The Quest for Peace;17062117;19300000;900;Superman IV: The Quest for Peace;41;2300000
2434;0;Drama;How She Move;1782666;0;940;How She Move;30;0
2435;17000000;Action Crime Drama Thriller;Running Scared;19311572;9500000;1220;Running Scared;70;-7500000
2436;0;Drama;Bobby Jones: Stroke of Genius;2897449;0;1200;Bobby Jones: Stroke of Genius;55;0
2437;17000000;Adventure;Shanghai Surprise;1,39E+16;0;970;Shanghai Surprise;29;-17000000
2438;40000000;Fantasy Drama Thriller Romance;The Illusionist;36960953;86915017;1100;The Illusionist;71;46915017
2439;17000000;Adventure Thriller;Roar;115641;2000000;1020;Roar;56;-15000000
2440;17000000;Drama Crime Thriller;Veronica Guerin;9583578;1569918;980;Veronica Guerin;68;-15430082
2441;17000000;Thriller Romance;Escobar: Paradise Lost;2,51E+16;3758328;1200;Escobar: Paradise Lost;61;-13241672
2442;17000000;Action Adventure Comedy Drama Science Fiction;Southland Tales;9349386;374743;1440;Southland Tales;52;-16625257
2443;15000000;Animation Family;Chasseurs de dragons;8,88E+15;0;800;Dragon Hunters;65;-15000000
2444;17000000;Action Adventure Science Fiction;Damnation Alley;2215261;8720000;910;Damnation Alley;50;-8280000
2445;17000000;Horror Thriller;The Apparition;6385234;9627492;820;The Apparition;45;-7372508
2446;16500000;Comedy Drama Family;My Girl;2,09E+16;0;1020;My Girl;70;-16500000
2447;16800000;Drama Mystery Romance;Fur: An Imaginary Portrait of Diane Arbus;4,36E+16;2281089;1220;Fur: An Imaginary Portrait of Diane Arbus;58;-14518911
2448;15000000;Crime Drama;Wall Street;24898687;43848069;1260;Wall Street;70;28848069
2449;16500000;Drama Romance;Sense and Sensibility;20898711;135000000;1360;Sense and Sensibility;72;118500000
2450;16500000;Drama Romance;Becoming Jane;18236284;37311672;1200;Becoming Jane;69;20811672
2451;16500000;Comedy;Sydney White;1074648;13620075;1080;Sydney White;60;-2879925
2452;16500000;Drama;House of Sand and Fog;12102725;16942795;1260;House of Sand and Fog;70;442795
2453;16400000;Drama;Dead Poets Society;5,55E+16;235860116;1290;Dead Poets Society;81;219460116
2454;16000000;Comedy;Dumb and Dumber;3,58E+15;247275374;1070;Dumb and Dumber;65;231275374
2455;16000000;Comedy Romance Drama;When Harry Met Sally...;18430419;92823546;960;When Harry Met Sally...;73;76823546
2456;16000000;Drama;The Verdict;7,98E+15;53977250;1290;The Verdict;74;37977250
2457;16000000;Comedy Adventure;Road Trip;1,48E+16;119754278;930;Road Trip;59;103754278
2458;0;Comedy Drama Romance;Varsity Blues;9,23E+15;0;1060;Varsity Blues;60;0
2459;15000000;Drama Comedy Romance;The Artist;2,99E+16;133432856;1000;The Artist;73;118432856
2460;16000000;Horror Thriller Mystery;The Unborn;15788784;76514050;870;The Unborn;48;60514050
2461;16000000;Comedy Drama Romance;Moonrise Kingdom;41083914;68263166;940;Moonrise Kingdom;76;52263166
2462;16000000;Horror;The Texas Chainsaw Massacre: The Beginning;21380635;0;910;The Texas Chainsaw Massacre: The Beginning;59;-16000000
2463;18500000;Drama;The Young Messiah;1,88E+16;6490401;1200;The Young Messiah;64;-12009599
2464;0;Comedy Family;The Master of Disguise;4382761;0;800;The Master of Disguise;37;0
2465;19000000;Fantasy Drama War;El laberinto del fauno;9,08E+15;83258226;1180;Pan's Labyrinth;76;64258226
2466;0;Action Comedy Family;See Spot Run;6,58E+16;0;940;See Spot Run;48;0
2467;16000000;Crime Drama Romance;Baby Boy;7854989;29381649;1300;Baby Boy;74;13381649
2468;16000000;Thriller Drama Horror;The Roommate;11807269;40492759;910;The Roommate;53;24492759
2469;17700000;Mystery Adventure Comedy Romance Drama;Joe Dirt;15976335;30987695;910;Joe Dirt;55;13287695
2470;15000000;Thriller Action Crime Drama;Double Impact;10484642;30102717;1100;Double Impact;53;15102717
2471;12000000;Crime Action Comedy;Hot Fuzz;38623178;80573774;1210;Hot Fuzz;74;68573774
2472;16000000;Comedy Drama Romance;The Women;88321;50007546;1140;The Women;46;34007546
2473;15000000;Drama Romance;Vicky Cristina Barcelona;32758254;96408652;960;Vicky Cristina Barcelona;67;81408652
2474;25000000;Action Adventure Drama Romance;Arn: Tempelriddaren;6091033;0;1390;Arn: The Knight Templar;64;-25000000
2475;16000000;Comedy Drama Romance;Boys and Girls;9119797;20627372;940;Boys and Girls;54;4627372
2476;0;Drama;White Oleander;9423866;0;1090;White Oleander;72;0
2477;16000000;Comedy Horror;Jennifer's Body;3,23E+16;31556061;1000;Jennifer's Body;53;15556061
2478;16000000;Comedy Crime Mystery;Drowning Mona;3021835;15427192;960;Drowning Mona;54;-572808
2479;16000000;Comedy Drama;Radio Days;7,61E+16;0;900;Radio Days;70;-16000000
2480;20000000;Drama Romance;Remember Me;36764666;0;1130;Remember Me;69;-20000000
2481;0;Drama Comedy Romance;How to Deal;3199784;0;990;How to Deal;57;0
2482;20000000;Comedy Science Fiction;My Stepmother is an Alien;9455596;13854000;1080;My Stepmother is an Alien;53;-6146000
2483;26000000;Drama;Philadelphia;4,43E+16;206678440;1250;Philadelphia;76;180678440
2484;16000000;Thriller Science Fiction Mystery;The Thirteenth Floor;19890428;18564088;1000;The Thirteenth Floor;68;2564088
2485;16000000;Comedy Drama;The Cookout;8,31E+15;12;970;The Cookout;46;-15999988
2486;0;Action Science Fiction Thriller;Meteor;2637355;0;1070;Meteor;51;0
2487;0;Comedy Drama Music;Duets;225453;0;1120;Duets;55;0
2488;16000000;Comedy Drama;Hollywood Ending;8,71E+15;0;1120;Hollywood Ending;64;-16000000
2489;6500000;Comedy Music;Detroit Rock City;5,70E+16;4217115;950;Detroit Rock City;67;-2282885
2490;16000000;Adventure Action Fantasy;Highlander;29253833;5900000;1160;Highlander;68;-10100000
2491;16000000;Drama;Things We Lost in the Fire;8842869;2849142;1130;Things We Lost in the Fire;67;-13150858
2492;16000000;Science Fiction Action Adventure;Steel;2,85E+16;1686429;970;Steel;43;-14313571
2493;16000000;Drama Romance;The Immigrant;1,38E+16;5867686;1170;The Immigrant;62;-10132314
2494;0;Drama History Family Romance;The White Countess;4,49E+16;0;1350;The White Countess;69;0
2495;20000000;Thriller Crime Drama Mystery;Trance;38802415;24261569;1010;Trance;65;4261569
2496;16000000;Romance Comedy;Soul Plane;9400404;14822346;860;Soul Plane;47;-1177654
2497;11000000;Comedy;Bienvenue chez les ch'tis;18923181;53191886;1060;Welcome to the Sticks;68;42191886
2498;0;Drama;Good;2397987;0;960;Good;63;0
2499;13000000;Fantasy Drama;Enter the Void;2039955;754249;1610;Enter the Void;72;-12245751
2500;16000000;Comedy Romance Horror;Vamps;7,25E+16;0;930;Vamps;48;-16000000
2501;16000000;Drama Family;Hachi: A Dog's Tale;43217089;47801389;930;Hachi: A Dog's Tale;77;31801389
2502;16000000;Crime Drama Thriller;Zulu;14529496;0;1100;Zulu;67;-16000000
2503;16000000;Western Drama;The Homesman;2,06E+16;3442853;1220;The Homesman;64;-12557147
2504;15600000;Comedy Drama;Juwanna Mann;2,24E+16;0;910;Juwanna Mann;42;-15600000
2505;0;War Drama;Ararat;1,33E+16;0;1150;Ararat;57;0
2506;0;Action Adventure Drama;Madison;212108;0;990;Madison;53;0
2507;15500000;Mystery Crime Drama Thriller;Slow Burn;6630856;1237615;930;Slow Burn;55;-14262385
2508;15300000;Drama Action Comedy;Wasabi;1,82E+16;0;940;Wasabi;62;-15300000
2509;15500000;Comedy Horror Science Fiction;Slither;17327279;0;950;Slither;63;-15500000
2510;15000000;Action Comedy Crime;Beverly Hills Cop;29843818;316360478;1050;Beverly Hills Cop;68;301360478
2511;18000000;Comedy Family;Home Alone;2186927;476684675;1030;Home Alone;71;458684675
2512;0;Family Comedy Drama;Three Men and a Baby;12335827;0;1020;Three Men and a Baby;58;0
2513;21000000;Comedy Romance;Tootsie;20818567;177200000;1160;Tootsie;69;156200000
2514;15000000;Action Romance War;Top Gun;58900647;356830601;1100;Top Gun;67;341830601
2515;17000000;Adventure Drama Action Romance;卧虎藏龙;4,57E+16;213525736;1200;Crouching Tiger, Hidden Dragon;72;196525736
2516;15000000;Drama;American Beauty;8,09E+15;356296601;1220;American Beauty;79;341296601
2517;15000000;Drama History;The King's Speech;54053576;414211549;1180;The King's Speech;76;399211549
2518;15000000;Comedy;Twins;1,76E+16;216614388;1070;Twins;57;201614388
2519;15000000;Drama Romance;The Yellow Handkerchief;3803495;317000;1020;The Yellow Handkerchief;64;-14683000
2520;15000000;Drama;The Color Purple;17571533;146292009;1540;The Color Purple;77;131292009
2521;16000000;Action Adventure Drama Thriller;해운대;4628525;11301649;1200;Tidal Wave;65;-4698351
2522;14000000;History Drama Thriller War;The Imitation Game;145364591;233555708;1130;The Imitation Game;80;219555708
2523;0;Comedy;Private Benjamin;1218838;0;1090;Private Benjamin;60;0
2524;15000000;Drama Music;Coal Miner's Daughter;3826685;67182787;1250;Coal Miner's Daughter;72;52182787
2525;15000000;Comedy Family;Diary of a Wimpy Kid;21095489;75700498;920;Diary of a Wimpy Kid;59;60700498
2526;15000000;Horror;Mama;47455148;146497771;1000;Mama;60;131497771
2527;15000000;Comedy Adventure Romance;National Lampoon's Vacation;22838834;61399552;980;National Lampoon's Vacation;71;46399552
2528;15000000;Comedy;Jackass Presents: Bad Grandpa;2,72E+16;151831537;920;Bad Grandpa;60;136831537
2529;15000000;Drama;The Queen;19113278;123384128;1030;The Queen;68;108384128
2530;15000000;Fantasy Comedy;Beetlejuice;58553213;73326666;920;Beetlejuice;71;58326666
2531;15000000;Comedy Drama;Why Did I Get Married?;2005111;55184721;1130;Why Did I Get Married?;61;40184721
2532;18000000;Drama Romance;Little Women;1,64E+16;0;1150;Little Women;70;-18000000
2533;17000000;Drama Horror Thriller;The Woman in Black;43675191;127730736;950;The Woman in Black;61;110730736
2534;15000000;Horror Thriller;When a Stranger Calls;4688212;66966987;870;When a Stranger Calls;54;51966987
2535;15000000;Comedy Family;Big Fat Liar;9125594;52970014;880;Big Fat Liar;56;37970014
2536;15000000;Drama War;The Deer Hunter;1,98E+16;50000000;1830;The Deer Hunter;78;35000000
2537;15000000;Comedy Drama;Wag the Dog;13581966;64256513;970;Wag the Dog;67;49256513
2538;17000000;Family Comedy;The Lizzie McGuire Movie;11927667;55534455;940;The Lizzie McGuire Movie;57;38534455
2539;35000000;Thriller Drama;Snitch;3,06E+16;42930462;1120;Snitch;58;7930462
2540;15000000;Horror Comedy Fantasy;Krampus;3,16E+16;61548707;980;Krampus;59;46548707
2541;15000000;Horror Mystery Science Fiction;The Faculty;21535126;40283321;1040;The Faculty;62;25283321
2542;0;Drama Music;What's Love Got to Do with It;7921311;0;1180;What's Love Got to Do with It;69;0
2543;15000000;Action Crime Drama;Cop Land;19284129;44862187;1040;Cop Land;66;29862187
2544;16000000;Comedy;Not Another Teen Movie;23423082;66468332;890;Not Another Teen Movie;55;50468332
2545;7000000;Crime Drama Thriller;End of Watch;4,95E+16;48126384;1090;End of Watch;72;41126384
2546;15000000;Crime Drama Thriller;The Skulls;1,14E+16;35007180;1060;The Skulls;58;20007180
2547;15000000;Drama Romance;The Theory of Everything;6,12E+15;123726688;1230;The Theory of Everything;78;108726688
2548;0;Comedy Crime;Malibu's Most Wanted;7314796;0;860;Malibu's Most Wanted;47;0
2549;15000000;Comedy Drama Romance;Where the Heart Is;6,86E+16;33771174;1200;Where the Heart Is;69;18771174
2550;15000000;Adventure Drama History War;Lawrence of Arabia;41286336;69995385;2160;Lawrence of Arabia;78;54995385
2551;15000000;Horror;Halloween II;12929525;39421467;1050;Halloween II;51;24421467
2552;15000000;Drama;Wild;42952942;52501541;1150;Wild;70;37501541
2553;15000000;Crime Thriller Horror Drama;The Last House on the Left;1,98E+16;32721635;1100;The Last House on the Left;62;17721635
2554;15000000;Comedy Romance;The Wedding Date;10194097;47175038;880;The Wedding Date;62;32175038
2555;13000000;Horror Thriller;Halloween: Resurrection;1,10E+16;37664855;940;Halloween: Resurrection;45;24664855
2556;16000000;Adventure Family Fantasy Comedy Romance;The Princess Bride;44533612;30857814;980;The Princess Bride;76;14857814
2557;15000000;Drama;The Great Debaters;1084158;30226144;1260;The Great Debaters;69;15226144
2558;15000000;Drama Action Thriller Crime;Drive;4,93E+16;78054825;1000;Drive;74;63054825
2559;15000000;Comedy;Confessions of a Teenage Drama Queen;7424798;29331068;890;Confessions of a Teenage Drama Queen;51;14331068
2560;15000000;Comedy Drama Romance;The Object of My Affection;5164281;46905889;1110;The Object of My Affection;56;31905889
2561;15000000;Horror Thriller Science Fiction;28 Weeks Later;34759855;64238440;1000;28 Weeks Later;65;49238440
2562;15000000;Drama;When the Game Stands Tall;7,30E+16;30127963;1150;When the Game Stands Tall;63;15127963
2563;14000000;Comedy Drama Family;Because of Winn-Dixie;3334804;32645546;1060;Because of Winn-Dixie;61;18645546
2564;20000000;Action Comedy Drama Romance;Love & Basketball;2027393;27728118;1240;Love & Basketball;74;7728118
2565;0;Action Comedy Thriller Romance;Grosse Pointe Blank;13817269;28084357;1070;Grosse Pointe Blank;69;28084357
2566;15000000;Comedy;All About Steve;13237835;40105542;990;All About Steve;47;25105542
2567;0;Mystery Thriller Horror;Book of Shadows: Blair Witch 2;3890223;0;900;Book of Shadows: Blair Witch 2;43;0
2568;15000000;Drama Fantasy Horror Thriller;The Craft;19517239;24769466;1010;The Craft;63;9769466
2569;15000000;Drama Thriller Crime Romance;Match Point;30669913;85306374;1240;Match Point;73;70306374
2570;0;Comedy Family;Ramona and Beezus;9681147;0;1030;Ramona and Beezus;61;0
2571;11500000;Drama Romance;The Remains of the Day;1,54E+16;23237911;1340;The Remains of the Day;75;11737911
2572;15000000;Drama;Boogie Nights;1985579;43101594;1550;Boogie Nights;75;28101594
2573;0;Action Adventure Drama Thriller;Nowhere to Run;11689337;0;940;Nowhere to Run;55;0
2574;15000000;Drama;Flicka;3043589;21000000;950;Flicka;61;6000000
2575;15000000;Horror Thriller;The Hills Have Eyes II;17141376;0;890;The Hills Have Eyes 2;52;-15000000
2576;14000000;Horror;Urban Legends: Final Cut;8885017;38574362;970;Urban Legends: Final Cut;44;24574362
2577;0;Fantasy Drama Science Fiction Romance Family;Tuck Everlasting;4115398;0;900;Tuck Everlasting;64;0
2578;20000000;Action Adventure Drama Thriller;The Marine;7679336;22165608;920;The Marine;50;2165608
2579;15000000;Action Comedy;Keanu;18268009;20566327;940;Keanu;60;5566327
2580;15000000;Drama Romance;Country Strong;7809701;20529194;1170;Country Strong;59;5529194
2581;15000000;Mystery Horror Science Fiction;Disturbing Behavior;9378688;17507368;840;Disturbing Behavior;55;2507368
2582;15000000;Drama Crime;The Place Beyond the Pines;35395129;35485608;1400;The Place Beyond the Pines;68;20485608
2583;15000000;Crime Action Thriller;The November Man;45317278;32556119;1080;The November Man;60;17556119
2584;15000000;Drama Mystery Thriller;Eye of the Beholder;4,30E+16;0;1090;Eye of the Beholder;53;-15000000
2585;15000000;Drama Thriller War;The Hurt Locker;4,70E+16;42000000;1310;The Hurt Locker;72;27000000
2586;15000000;Fantasy Drama Horror Action Thriller;Firestarter;11379652;17080167;1140;Firestarter;59;2080167
2587;15000000;Crime Thriller;Killing Them Softly;24612603;37930465;970;Killing Them Softly;58;22930465
2588;15000000;Thriller;A Most Wanted Man;2,67E+16;31554855;1210;A Most Wanted Man;65;16554855
2589;0;Comedy;Freddy Got Fingered;8,71E+15;0;870;Freddy Got Fingered;46;0
2590;0;Adventure Animation Comedy Science Fiction Family;VeggieTales: The Pirates Who Don't Do Anything;1,80E+16;0;850;VeggieTales: The Pirates Who Don't Do Anything;59;0
2591;15000000;Music Documentary;U2 3D;3,35E+16;22730842;850;U2 3D;67;7730842
2592;25000000;Action Fantasy Science Fiction;Highlander: Endgame;11782725;15843608;870;Highlander: Endgame;44;-9156392
2593;0;Crime Drama Music;Idlewild;2711955;0;1210;Idlewild;51;0
2594;15000000;Drama Romance;One Day;16629173;59389433;1070;One Day;70;44389433
2595;15000000;Drama;Whip It;2005902;16633035;1110;Whip It;67;1633035
2596;15000000;Crime Thriller;Knockaround Guys;8113634;12000000;920;Knockaround Guys;59;-3000000
2597;0;Action Comedy Thriller Crime;Confidence;9,87E+15;0;970;Confidence;64;0
2598;0;Fantasy Comedy;The Muse;2857936;0;970;The Muse;53;0
2599;20000000;Drama Music;De-Lovely;3138118;0;1250;De-Lovely;63;-20000000
2600;15000000;Comedy Drama Romance;New York Stories;6684096;0;1240;New York Stories;62;-15000000
2601;0;Family;Barney's Great Adventure;722911;0;760;Barney's Great Adventure;29;0
2602;15000000;Action;The Man with the Iron Fists;17672021;15608545;960;The Man with the Iron Fists;52;608545
2603;15000000;Drama Comedy Romance;Home Fries;3033471;10443316;930;Home Fries;48;-4556684
2604;0;Romance;Here On Earth;3313257;0;960;Here On Earth;54;0
2605;15000000;Comedy Science Fiction;Brazil;41089863;0;1320;Brazil;75;-15000000
2606;15000000;Music Drama Romance;Raise Your Voice;109071;14867514;1030;Raise Your Voice;60;-132486
2607;15000000;Comedy Crime;The Big Lebowski;49230089;46189568;1170;The Big Lebowski;78;31189568
2608;15000000;Drama;Black Snake Moan;11429607;10903846;1160;Black Snake Moan;66;-4096154
2609;15000000;Action Crime Drama Thriller;Dark Blue;6373316;9237470;1180;Dark Blue;65;-5762530
2610;16000000;Drama Thriller;A Mighty Heart;9717392;18928871;1000;A Mighty Heart;67;2928871
2611;15000000;Drama Comedy Romance;Whatever It Takes;8074807;9902115;940;Whatever It Takes;50;-5097885
2612;20000000;Comedy;Boat Trip;7034752;8586376;940;Boat Trip;47;-11413624
2613;0;Comedy Drama History Romance;The Importance of Being Earnest;7250379;0;970;The Importance of Being Earnest;67;0
2614;0;Comedy Drama Fantasy Romance;The Love Letter;116873;0;980;The Love Letter;47;0
2615;0;Drama Family;Hoot;7712206;0;910;Hoot;55;0
2616;15000000;Comedy Drama Crime;In Bruges;25329493;34533783;1070;In Bruges;74;19533783
2617;15;Comedy;Peeples;5,11E+16;0;950;Peeples;56;-15
2618;15000000;Comedy Music;The Rocker;1,38E+16;8762890;1020;The Rocker;56;-6237110
2619;15000000;Comedy;Post Grad;7,45E+16;6405245;890;Post Grad;50;-8594755
2620;15000000;Drama;Promised Land;13568302;8138788;1060;Promised Land;60;-6861212
2621;15000000;Comedy Romance;Whatever Works;21857387;35097815;920;Whatever Works;68;20097815
2622;15000000;Thriller;The In Crowd;249245;5217498;1050;The In Crowd;47;-9782502
2623;15000000;Adventure Crime Drama Mystery Western;The Three Burials of Melquiades Estrada;1,22E+16;12036149;1210;The Three Burials of Melquiades Estrada;70;-2963851
2624;0;Comedy Drama History;Jakob the Liar;8962245;0;1200;Jakob the Liar;60;0
2625;15000000;Action Comedy Crime Mystery;Kiss Kiss Bang Bang;32690038;15785148;1030;Kiss Kiss Bang Bang;72;785148
2626;25000000;Thriller Comedy Horror;Idle Hands;8583217;4152230;920;Idle Hands;61;-20847770
2627;15000000;Thriller Drama Mystery;Mulholland Drive;3160985;20117339;1470;Mulholland Drive;76;5117339
2628;0;Drama Fantasy Horror Romance;Blood and Chocolate;12295216;0;980;Blood and Chocolate;54;0
2629;22000000;Comedy Drama Romance;You Will Meet a Tall Dark Stranger;124654;0;980;You Will Meet a Tall Dark Stranger;58;-22000000
2630;15000000;Drama Romance Science Fiction;Never Let Me Go;3,10E+16;9455232;1040;Never Let Me Go;68;-5544768
2631;0;Drama;The Company;1485324;0;2760;The Company;70;0
2632;15000000;Thriller Crime Mystery;Transsiberian;11428903;5926410;1110;Transsiberian;65;-9073590
2633;15000000;Adventure Drama;The Clan of the Cave Bear;5484679;0;980;The Clan of the Cave Bear;48;-15000000
2634;0;Comedy Drama;Crazy in Alabama;5770246;0;1110;Crazy in Alabama;65;0
2635;15000000;Horror Thriller Crime;Funny Games;1,52E+16;7938872;1120;Funny Games;63;-7061128
2636;0;Drama Thriller Science Fiction;Listening;2414721;0;1000;Listening;55;0
2637;0;Drama;Felicia's Journey;470645;0;1160;Felicia's Journey;66;0
2638;92620000;Drama Science Fiction;Metropolis;3,24E+16;650422;1530;Metropolis;80;-91969578
2639;12000000;Action Thriller Science Fiction;Banlieue 13;17493735;9584131;840;District B13;65;-2415869
2640;8000000;Drama Crime;Things to Do in Denver When You're Dead;6,93E+15;529766;1160;Things to Do in Denver When You're Dead;67;-7470234
2641;15000000;Action Drama History;刺客聶隱娘;8142166;632542;1050;The Assassin;66;-14367458
2642;15000000;Drama Comedy War Crime Thriller;Buffalo Soldiers;6329672;0;980;Buffalo Soldiers;65;-15000000
2643;0;Thriller Drama Mystery;Возвращение;7,74E+15;0;1050;The Return;74;0
2644;8500000;Adventure Action Thriller;Ong Bak 2;9029489;8936663;980;Ong Bak 2;60;436663
2645;12000000;Adventure Action Drama;Centurion;22708647;6814789;970;Centurion;59;-5185211
2646;15000000;Drama Action Thriller;Silent Trigger;2609057;76382;930;Silent Trigger;50;-14923618
2647;15000000;Mystery Drama Crime Thriller Horror;The Midnight Meat Train;1,99E+16;3533227;980;The Midnight Meat Train;60;-11466773
2648;15000000;Drama;Winnie Mandela;1897761;0;1070;Winnie Mandela;52;-15000000
2649;15000000;Drama Thriller Crime;The Son of No One;7701186;0;900;The Son of No One;48;-15000000
2650;15000000;Action Comedy Drama History;All The Queen's Men;1833058;23000;990;All The Queen's Men;61;-14977000
2651;15000000;Comedy Drama Romance Fantasy Music;The Good Night;1,22E+16;20380;930;The Good Night;57;-14979620
2652;0;Drama Fantasy;Bathory;2500218;0;1410;Bathory: Countess of Blood;56;0
2653;20000000;Animation Adventure Family;Khumba;6459787;27187375;850;Khumba;58;7187375
2654;7000000;Thriller Science Fiction;Autómata;49808505;0;1100;Automata;56;-7000000
2655;0;Action Adventure Fantasy;Dungeons & Dragons: Wrath of the Dragon God;4901936;0;1050;Dungeons & Dragons: Wrath of the Dragon God;48;0
2656;15000000;Drama;Chiamatemi Francesco - Il Papa della gente;738646;0;;Chiamatemi Francesco - Il Papa della gente;73;-15000000
2657;15000000;Drama Action Thriller Crime;新宿事件;5,29E+16;0;1190;Shinjuku Incident;67;-15000000
2658;0;Drama Foreign;Pandaemonium;1,65E+16;0;1240;Pandaemonium;45;0
2659;14600000;Romance Fantasy Drama Comedy;Groundhog Day;52744331;70906973;1010;Groundhog Day;74;56306973
2660;14800000;Comedy Drama Music;Magic Mike XXL;2,97E+16;122513057;1150;Magic Mike XXL;63;107713057
2661;14500000;Drama Romance;Romeo + Juliet;4,15E+16;147298761;1200;Romeo + Juliet;67;132798761
2662;10000000;Drama War;Elle s'appelait Sarah;1,01E+16;17511906;1110;Sarah's Key;72;7511906
2663;14500000;Drama;Freedom;4,39E+16;0;980;Freedom;58;-14500000
2664;14000000;Western;Unforgiven;37380435;159157447;1310;Unforgiven;77;145157447
2665;14200000;Drama;Manderlay;705145;674918;1390;Manderlay;69;-13525082
2666;15000000;Drama Romance;Slumdog Millionaire;5,93E+15;377910544;1200;Slumdog Millionaire;76;362910544
2667;14000000;Drama Romance Thriller;Fatal Attraction;16742972;320145693;1190;Fatal Attraction;66;306145693
2668;14000000;Romance Comedy;Pretty Woman;45473484;463000000;1190;Pretty Woman;70;449000000
2669;0;Adventure Comedy;Crocodile Dundee II;15474831;239606210;1100;Crocodile Dundee II;55;239606210
2670;0;Thriller Mystery Drama Crime;Broken Horses;4289676;0;1010;Broken Horses;50;0
2671;14000000;Drama War;Born on the Fourth of July;25949277;161001698;1450;Born on the Fourth of July;67;147001698
2672;14000000;Comedy;Cool Runnings;2,24E+16;154864401;980;Cool Runnings;68;140864401
2673;15000000;Mystery Horror;My Bloody Valentine;13706357;100734718;1010;My Bloody Valentine;53;85734718
2674;13000000;Drama Music;Stomp the Yard;692205;75511123;1140;Stomp the Yard;61;62511123
2675;14000000;Adventure Action Thriller;The Spy Who Loved Me;2,72E+16;185438673;1250;The Spy Who Loved Me;66;171438673
2676;14000000;Horror Thriller;Urban Legend;12159009;72527595;990;Urban Legend;56;58527595
2677;0;Comedy Drama Romance;Good Deeds;4448494;0;1110;Good Deeds;62;0
2678;14000000;Action Adventure Drama Family;White Fang;1313724;34793160;1070;White Fang;65;20793160
2679;0;Comedy Family;Superstar;404701;0;810;Superstar;51;0
2680;13000000;History Drama;The Iron Lady;233784;114956699;1050;The Iron Lady;62;101956699
2681;0;Action Adventure Animation Comedy Family;Jonah: A VeggieTales Movie;1446172;0;820;Jonah: A VeggieTales Movie;64;0
2682;14000000;Drama Romance;Poetic Justice;3650857;27515786;1090;Poetic Justice;69;13515786
2683;14000000;Action Adventure Comedy;All About the Benjamins;5102258;25482931;950;All About the Benjamins;58;11482931
2684;14000000;Comedy Horror Romance;Vampire in Brooklyn;6,77E+15;19800000;1000;Vampire in Brooklyn;45;5800000
2685;14000000;Horror Thriller Fantasy;Exorcist II: The Heretic;1,15E+16;30749142;1180;Exorcist II: The Heretic;45;16749142
2686;0;Horror Thriller;An American Haunting;7436315;0;830;An American Haunting;53;0
2687;14000000;Comedy Romance;My Boss's Daughter;1,48E+16;0;830;My Boss's Daughter;44;-14000000
2688;14000000;Thriller Mystery Adventure;A Perfect Getaway;20792603;22852638;980;A Perfect Getaway;62;8852638
2689;14000000;Comedy;Our Family Wedding;6,73E+15;21409028;1030;Our Family Wedding;57;7409028
2690;0;Comedy;Dead Man on Campus;7,71E+15;0;960;Dead Man on Campus;56;0
2691;12000000;Comedy Drama War;Tea with Mussolini;2,24E+16;21001563;1170;Tea with Mussolini;58;9001563
2692;0;Horror Thriller;Thinner;7866961;0;920;Thinner;55;0
2693;0;Drama Music Romance;New York, New York;3876242;0;1550;New York, New York;61;0
2694;0;Comedy Drama;Crooklyn;189218;0;1150;Crooklyn;67;0
2695;11000000;Comedy Romance;I Think I Love My Wife;4536745;13196245;900;I Think I Love My Wife;50;2196245
2696;11000000;Horror Science Fiction;Jason X;1,12E+16;16951798;910;Jason X;45;5951798
2697;0;History Drama;Bobby;11706309;0;1200;Bobby;64;0
2698;14000000;Comedy Romance;Head Over Heels;466723;10424470;860;Head Over Heels;53;-3575530
2699;14000000;Comedy;Fun Size;7,49E+15;11417362;870;Fun Size;55;-2582638
2700;14000000;Drama;Le scaphandre et le papillon;1365494;19777647;1120;The Diving Bell and the Butterfly;74;5777647
2701;26000000;Romance Drama;Little Children;11942862;14821658;1360;Little Children;69;-11178342
2702;14000000;Drama Mystery Thriller;Gossip;5833687;5108820;900;Gossip;55;-8891180
2703;14000000;Drama Romance;A Walk on the Moon;6370267;0;1070;A Walk on the Moon;62;-14000000
2704;0;Action Drama Thriller;Catch a Fire;4052219;4291965;1010;Catch a Fire;64;4291965
2705;0;Horror Mystery Thriller;Soul Survivors;3231848;0;840;Soul Survivors;44;0
2706;14000000;Drama Romance;Jefferson in Paris;900442;2474000;1390;Jefferson in Paris;52;-11526000
2707;0;Comedy Romance;Easy Virtue;8387573;0;930;Easy Virtue;63;0
2708;0;Action Adventure Drama Romance;Caravans;633004;0;1270;Caravans;58;0
2709;0;History Drama;Mr. Turner;9242554;5405500;1500;Mr. Turner;63;5405500
2710;0;Drama Romance;Les herbes folles;1866443;0;1040;Wild Grass;58;0
2711;0;Drama History;Amen.;5,93E+16;0;1320;Amen.;71;0
2712;12000000;History Action;剑雨;4930129;0;1170;Reign of Assassins;67;-12000000
2713;0;Comedy Drama History;The Lucky Ones;8747922;0;1130;The Lucky Ones;63;0
2714;14000000;Drama;Margaret;4,90E+16;46495;1490;Margaret;61;-13953505
2715;108;Comedy Horror;Stan Helsing;7,41E+15;0;900;Stan Helsing;40;-108
2716;14000000;Romance Drama;Flipped;24210698;1755212;890;Flipped;74;-12244788
2717;14000000;Drama Romance;Brokeback Mountain;44135568;178043761;1340;Brokeback Mountain;75;164043761
2718;12000000;Comedy Drama Romance;Clueless;16051328;0;970;Clueless;69;-12000000
2719;13500000;Drama Romance;Far from Heaven;9,98E+15;29027914;1070;Far from Heaven;69;15527914
2720;14000000;Comedy;Hot Tub Time Machine 2;1,66E+16;12314651;930;Hot Tub Time Machine 2;50;-1685349
2721;13500000;Drama;Quills;7,26E+15;7060876;1240;Quills;68;-6439124
2722;15000000;Comedy Crime;Seven Psychopaths;32306455;19422261;1100;Seven Psychopaths;67;4422261
2723;0;Drama Mystery Thriller;The Caveman's Valentine;4722403;0;1050;The Caveman's Valentine;60;0
2724;18339750;Drama History War;Der Untergang;32445895;92180910;1560;Downfall;77;73841160
2725;12806000;Drama;Mar adentro;1,74E+16;38535221;1250;The Sea Inside;72;25729221
2726;13300000;Thriller Science Fiction Drama;Under the Skin;29782161;5380251;1080;Under the Skin;60;-7919749
2727;13000000;Comedy Drama War;Good Morning, Vietnam;18362333;123922370;1210;Good Morning, Vietnam;71;110922370
2728;13400000;Action Comedy Thriller;The Last Godfather;6,81E+15;16700000;1000;The Last Godfather;47;3300000
2729;13000000;Documentary Music Family;Justin Bieber: Never Say Never;6735922;98441954;1050;Justin Bieber: Never Say Never;48;85441954
2730;13000000;Drama Thriller;Black Swan;9,13E+15;327803731;1080;Black Swan;73;314803731
2731;13000000;Drama Crime;The Godfather: Part II;1,06E+16;47542841;2000;The Godfather: Part II;83;34542841
2732;13000000;Drama Family Romance Music;Save the Last Dance;9,97E+15;91038276;1120;Save the Last Dance;63;78038276
2733;7000000;Horror Thriller;A Nightmare on Elm Street 4: The Dream Master;17113408;72500000;990;A Nightmare on Elm Street 4: The Dream Master;58;65500000
2734;16000000;Drama;Miracles from Heaven;10248439;77000000;1170;Miracles from Heaven;67;61000000
2735;13000000;Comedy;Dude, Where’s My Car?;25316146;73180723;830;Dude, Where’s My Car?;52;60180723
2736;13000000;Crime Action Adventure Drama Western;Young Guns;9499325;44726644;1070;Young Guns;66;31726644
2737;13000000;Comedy;St. Vincent;43791745;54837234;1020;St. Vincent;71;41837234
2738;12500000;Comedy Romance;About Last Night;11828068;49002684;1000;About Last Night;60;36502684
2739;16000000;Comedy Romance Drama;10 Things I Hate About You;54550275;53478166;970;10 Things I Hate About You;73;37478166
2740;13000000;Comedy Family;The New Guy;1,35E+16;0;880;The New Guy;57;-13000000
2741;0;Comedy;National Lampoon's Loaded Weapon 1;12963328;0;840;National Lampoon's Loaded Weapon 1;57;0
2742;17000000;Horror Drama Thriller;The Shallows;6,08E+16;119100758;860;The Shallows;62;102100758
2743;13000000;Science Fiction Thriller;The Butterfly Effect;73307513;96060858;1130;The Butterfly Effect;73;83060858
2744;0;Comedy Family;Snow Day;7964289;0;890;Snow Day;48;0
2745;13000000;Comedy Drama;This Christmas;2388918;0;1170;This Christmas;71;-13000000
2746;12000000;Science Fiction Comedy Family;Baby Geniuses;4580081;36450736;970;Baby Geniuses;33;24450736
2747;13000000;Action Adventure Comedy Thriller;The Big Hit;6425528;27007143;910;The Big Hit;61;14007143
2748;12000000;Comedy Drama Family;Harriet the Spy;463093;0;1000;Harriet the Spy;57;-12000000
2749;13000000;Drama Horror;Child's Play 2;16681567;35763605;840;Child's Play 2;58;22763605
2750;13200000;Crime Thriller;No Good Deed;2,47E+16;53830415;830;No Good Deed;56;40630415
2751;18000000;Science Fiction Horror Thriller;The Mist;37104353;57096190;1260;The Mist;67;39096190
2752;15000000;Drama Science Fiction;Ex Machina;95130041;36869414;1080;Ex Machina;76;21869414
2753;13000000;Fantasy Drama Comedy;Being John Malkovich;27546914;22863596;1120;Being John Malkovich;73;9863596
2754;6000000;Comedy Romance;Two Can Play That Game;2,27E+16;0;900;Two Can Play That Game;66;-6000000
2755;13000000;Family Adventure Science Fiction;Earth to Echo;1,74E+16;45300000;890;Earth to Echo;57;32300000
2756;13000000;Drama Romance;Crazy/Beautiful;6130096;16929123;990;Crazy/Beautiful;66;3929123
2757;19000000;Action Adventure Drama War;Letters from Iwo Jima;2,45E+16;68673228;1410;Letters from Iwo Jima;72;49673228
2758;13000000;Adventure Comedy Drama Science Fiction;The Astronaut Farmer;6,76E+15;11130889;1040;The Astronaut Farmer;62;-1869111
2759;13000000;Comedy Romance;Woo;1750054;8026971;840;Woo;55;-4973029
2760;6000000;Drama Thriller;Room;6,61E+15;35401758;1170;Room;81;29401758
2761;0;Comedy;Dirty Work;9066881;0;820;Dirty Work;65;0
2762;13000000;Comedy Crime Horror Thriller;Serial Mom;6170139;7820688;950;Serial Mom;64;-5179312
2763;13000000;Comedy;Dick;4,74E+16;27500000;940;Dick;57;14500000
2764;0;Drama Thriller;Light It Up;1212956;0;990;Light It Up;66;0
2765;13000000;Music Drama;54;1,19E+16;16757163;1060;54;55;3757163
2766;0;Adventure Comedy Drama Romance;Bubble Boy;1,01E+16;0;840;Bubble Boy;51;0
2767;13000000;Comedy Crime Thriller;Birthday Girl;5831302;0;930;Birthday Girl;61;-13000000
2768;13000000;Comedy;21 & Over;35522027;48065672;930;21 & Over;57;35065672
2769;13000000;Drama Romance;Paris, je t'aime;10573191;4857367;1200;Paris, je t'aime;68;-8142633
2770;0;Drama;Resurrecting the Champ;4898437;0;1120;Resurrecting the Champ;59;0
2771;13000000;Comedy Drama Romance;Admission;1,76E+16;18000000;1070;Admission;54;5000000
2772;0;Romance Drama;La veuve de Saint-Pierre;1,78E+16;0;1120;The Widow of Saint-Pierre;67;0
2773;15000000;Drama Thriller Mystery;Chloe;26373864;8459458;960;Chloe;59;-6540542
2774;13000000;Comedy Crime Drama;Faithful;1,65E+16;9789900;910;Faithful;48;-3210100
2775;13000000;Drama Action Comedy Crime;Find Me Guilty;1,23E+16;2636637;1250;Find Me Guilty;65;-10363363
2776;13000000;Drama Romance;The Perks of Being a Wallflower;4,34E+16;33400000;1020;The Perks of Being a Wallflower;77;20400000
2777;3000000;Action;Excessive Force;1,28E+16;1200000;870;Excessive Force;45;-1800000
2778;13000000;Drama;Infamous;3,68E+16;1151330;1100;Infamous;64;-11848670
2779;0;Drama Romance Western;The Claim;2996284;0;1200;The Claim;56;0
2780;13000000;Thriller Horror;The Vatican Tapes;10475368;1784763;910;The Vatican Tapes;46;-11215237
2781;14350531;Action Comedy Science Fiction;Attack the Block;3,10E+16;3964682;880;Attack the Block;63;-10385849
2782;10000000;Drama Romance War;In the Land of Blood and Honey;4,27E+16;303877;1270;In the Land of Blood and Honey;58;-9696123
2783;13000000;Crime Thriller;The Call;34532418;68572378;940;The Call;66;55572378
2784;0;History Drama War Action;인천상륙작전;6116436;0;1100;Operation Chromite;58;0
2785;0;Family Action Adventure;The Crocodile Hunter: Collision Course;1,71E+16;33082548;900;The Crocodile Hunter: Collision Course;53;33082548
2786;13000000;Comedy Drama Romance;I Love You Phillip Morris;19664699;10652035;980;I Love You Phillip Morris;64;-2347965
2787;12000000;Adventure Drama;La Guerre du feu;6537986;55260558;1000;Quest for Fire;71;43260558
2788;12500000;Drama Romance;Antwone Fisher;13349012;23367586;1200;Antwone Fisher;67;10867586
2789;0;Drama Romance;The Emperor's Club;6796079;0;1080;The Emperor's Club;69;0
2790;12500000;Action Thriller Crime Romance;True Romance;35268557;12281551;1200;True Romance;75;-218449
2791;3100000;Romance Science Fiction;Womb;7453347;0;1110;Womb;59;-3100000
2792;12500000;Crime Drama Mystery;Glengarry Glen Ross;13939054;10725228;1000;Glengarry Glen Ross;75;-1774772
2793;13000000;Crime Drama Thriller;The Killer Inside Me;11892615;0;1090;The Killer Inside Me;60;-13000000
2794;0;Drama Fantasy Horror Thriller;Cat People;569872;0;1180;Cat People;60;0
2795;12500000;Horror Mystery Thriller;Sorority Row;8780512;27206120;1010;Sorority Row;54;14706120
2796;0;Adventure Drama Romance;The Prisoner of Zenda;4021389;0;1010;The Prisoner of Zenda;84;0
2797;12000000;Comedy Romance Drama;Lars and the Real Girl;15817096;11293663;1060;Lars and the Real Girl;71;-706337
2798;12500000;War Drama;The Boy in the Striped Pyjamas;3,48E+16;20416563;940;The Boy in the Striped Pyjamas;77;7916563
2799;12800000;Drama Crime Music;Dancer in the Dark;22022228;40031879;1400;Dancer in the Dark;76;27231879
2800;0;Drama Romance;Oscar and Lucinda;1,39E+16;0;1320;Oscar and Lucinda;62;0
2801;12500000;Crime Drama;The Funeral;2950618;1227324;990;The Funeral;73;-11272676
2802;15000000;Comedy Drama Romance;Solitary Man;7497306;5024782;900;Solitary Man;58;-9975218
2803;20000000;Action Comedy Thriller;Machete;2,64E+16;31327899;1050;Machete;63;11327899
2804;12500000;Crime Comedy Drama;Casino Jack;6546037;1083683;1080;Casino Jack;60;-11416317
2805;12300000;Animation Adventure Family;The Land Before Time;2,87E+16;84460846;690;The Land Before Time;70;72160846
2806;0;Action Adventure Drama History War;태극기 휘날리며;9,57E+15;15;1400;Tae Guk Gi: The Brotherhood of War;74;15
2807;12500000;Drama Family;The Perfect Game;9,04E+15;3878993;1180;The Perfect Game;63;-8621007
2808;8000000;Drama Horror Thriller;The Exorcist;47584643;441306145;1220;The Exorcist;75;433306145
2809;7000000;Horror Thriller Adventure;Jaws;50152327;470654000;1240;Jaws;75;463654000
2810;11000000;Comedy Romance;American Pie;6,08E+15;235483004;950;American Pie;64;224483004
2811;12516654;Animation Comedy Drama Family;Ernest et Célestine;11103202;8109160;780;Ernest & Celestine;76;-4407494
2812;25000000;Action Adventure Comedy;The Golden Child;1,53E+16;79817939;940;The Golden Child;56;54817939
2813;12000000;Comedy Romance;Think Like a Man;6035152;96070507;1220;Think Like a Man;69;84070507
2814;12000000;Comedy Drama;Barbershop;10297189;75781642;1020;Barbershop;62;63781642
2815;12000000;Action Adventure Science Fiction Thriller;Star Trek II: The Wrath of Khan;22434102;96800000;1130;Star Trek II: The Wrath of Khan;73;84800000
2816;15000000;Comedy Mystery;Ace Ventura: Pet Detective;41249004;107217396;860;Ace Ventura: Pet Detective;64;92217396
2817;12000000;Thriller Science Fiction;WarGames;2,32E+16;79567667;1140;WarGames;70;67567667
2818;12000000;Crime Drama Romance Thriller;Witness;19195399;68706993;1130;Witness;70;56706993
2819;12000000;Action Thriller War;Act of Valor;2,20E+16;81272766;1100;Act of Valor;63;69272766
2820;12000000;Music Drama Romance Crime;Step Up;4,55E+16;114194847;1040;Step Up;67;102194847
2821;12000000;Animation Comedy;Beavis and Butt-Head Do America;1260629;0;810;Beavis and Butt-Head Do America;65;-12000000
2822;12000000;Comedy Crime Romance;Jackie Brown;4,06E+16;39673162;1540;Jackie Brown;73;27673162
2823;12000000;Comedy Adventure;Harold & Kumar Escape from Guantanamo Bay;2,62E+16;43493123;1070;Harold & Kumar Escape from Guantanamo Bay;62;31493123
2824;15000000;Science Fiction Drama Thriller;Chronicle;64504747;145000000;840;Chronicle;66;130000000
2825;12000000;Music Drama Romance;Yentl;3389249;30400000;1320;Yentl;62;18400000
2826;5000000;Family Fantasy Science Fiction Adventure Comedy;Time Bandits;14779537;42365581;1160;Time Bandits;66;37365581
2827;12000000;Action Adventure Comedy Drama Family;Crossroads;6,70E+16;61141030;930;Crossroads;47;49141030
2828;12000000;Comedy Crime;Project X;49070321;100000000;880;Project X;65;88000000
2829;12000000;Drama History War;Patton;21933822;89800000;1720;Patton;73;77800000
2830;12000000;Horror Thriller;One Hour Photo;20624896;52223306;960;One Hour Photo;66;40223306
2831;12000000;Horror Science Fiction Thriller;Quarantine;8083995;40855419;890;Quarantine;55;28855419
2832;12000000;Drama Horror Thriller;The Eye;11135734;56309766;980;The Eye;55;44309766
2833;12000000;Comedy Family;Johnson Family Vacation;4623609;31179516;970;Johnson Family Vacation;47;19179516
2834;12000000;Comedy;How High;1,15E+16;31155435;930;How High;63;19155435
2835;0;Comedy Family Fantasy Drama;The Muppet Christmas Carol;15085981;27281507;850;The Muppet Christmas Carol;72;27281507
2836;12000000;Drama Romance;Frida;18422327;56298474;1230;Frida;73;44298474
2837;12000000;Documentary Music;Katy Perry: Part of Me;8410688;32726956;930;Katy Perry: Part of Me;65;20726956
2838;12000000;Romance Drama;The Fault in Our Stars;74358971;307166834;1250;The Fault in Our Stars;76;295166834
2839;12000000;Drama Crime;Rounders;1,84E+16;22921898;1210;Rounders;69;10921898
2840;0;Drama Comedy;Top Five;15896312;25434291;1020;Top Five;63;25434291
2841;12000000;Horror Science Fiction;Prophecy;8,62E+15;54000000;1020;Prophecy;54;42000000
2842;12000000;Horror Mystery Thriller;Stir of Echoes;6044161;21133087;990;Stir of Echoes;65;9133087
2843;12000000;Drama;Philomena;2,90E+16;100129872;980;Philomena;74;88129872
2844;0;Comedy Drama;The Upside of Anger;62464;0;1180;The Upside of Anger;64;0
2845;0;Horror Drama Thriller Science Fiction;The Boys from Brazil;5315213;0;1250;The Boys from Brazil;66;0
2846;12000000;Fantasy Romance Family Comedy;Aquamarine;16931846;23006849;1040;Aquamarine;58;11006849
2847;12000000;Drama Mystery Romance;Paper Towns;64610671;85512300;1090;Paper Towns;61;73512300
2848;0;Comedy;My Baby's Daddy;4480167;51;860;My Baby's Daddy;43;51
2849;12000000;Drama Adventure;Nebraska;29223881;17654912;1150;Nebraska;74;5654912
2850;0;Horror Comedy Thriller;Tales from the Crypt: Demon Knight;7710797;0;920;Tales from the Crypt: Demon Knight;67;0
2851;12000000;Comedy Family Fantasy Science Fiction;Max Keeble's Big Move;1,08E+16;17292381;860;Max Keeble's Big Move;54;5292381
2852;12000000;Comedy Drama;Young Adult;16183746;22939027;940;Young Adult;56;10939027
2853;12000000;Action Thriller Crime;Crank;4,80E+16;42931041;880;Crank;66;30931041
2854;0;Comedy Romance;How to Be a Player;120245;13960203;930;Def Jam's How to Be a Player;53;13960203
2855;12000000;Comedy Drama Romance;Living Out Loud;700792;12902790;1000;Living Out Loud;53;902790
2856;0;Comedy Drama Romance;Just Wright;10409253;21520719;1000;Just Wright;61;21520719
2857;0;Drama;Rachel Getting Married;14345428;0;1130;Rachel Getting Married;61;0
2858;12000000;Romance Crime Drama;The Postman Always Rings Twice;6,80E+15;0;1220;The Postman Always Rings Twice;64;-12000000
2859;0;Drama Romance;Girl with a Pearl Earring;19944479;31466789;1010;Girl with a Pearl Earring;64;31466789
2860;14000000;Action Drama History War Adventure;Das Boot;26967494;85000000;1490;Das Boot;79;71000000
2861;12000000;Comedy;Sorority Boys;3,44E+16;0;930;Sorority Boys;46;-12000000
2862;0;Comedy Drama Science Fiction;About Time;7,48E+15;87100449;1230;About Time;78;87100449
2863;0;Adventure Drama Action Romance;十面埋伏;21064082;92863945;1190;House of Flying Daggers;71;92863945
2864;12000000;Drama Thriller;Arbitrage;1640512;35485056;1000;Arbitrage;61;23485056
2865;12000000;Science Fiction Thriller;Project Almanac;32940597;32248241;1060;Project Almanac;64;20248241
2866;12000000;Drama History Music;Cadillac Records;13427427;0;1090;Cadillac Records;69;-12000000
2867;0;Action Comedy;Screwed;5359381;0;810;Screwed;49;0
2868;8000000;Action Thriller Science Fiction;Fortress;8708229;6739141;950;Fortress;57;-1260859
2869;12000000;Comedy Drama;For Your Consideration;4,33E+16;5542025;860;For Your Consideration;59;-6457975
2870;0;Drama Comedy;Celebrity;7594593;0;1130;Celebrity;60;0
2871;12000000;Drama Comedy;Running with Scissors;4,77E+15;6754898;1160;Running with Scissors;58;-5245102
2872;12000000;Comedy Romance;From Justin to Kelly;1623338;4922166;900;From Justin to Kelly;30;-7077834
2873;12000000;Comedy;Girl 6;2993939;4939939;1080;Girl 6;57;-7060061
2874;12000000;Mystery Thriller;In the Cut;10536092;23;1190;In the Cut;46;-11999977
2875;12000000;Drama Romance;Two Lovers;8290636;3148182;1100;Two Lovers;66;-8851818
2876;0;Comedy Drama;Last Orders;3,60E+16;0;1090;Last Orders;60;0
2877;11000000;Horror Drama Science Fiction;괴물;2765527;88489643;1190;The Host;67;77489643
2878;0;Adventure Crime Thriller;The Pursuit of D.B. Cooper;1379643;0;1000;The Pursuit of D.B. Cooper;68;0
2879;12000000;Comedy Horror Thriller Western;Ravenous;9164386;0;1000;Ravenous;69;-12000000
2880;12000000;Comedy Drama;Charlie Bartlett;9779444;0;970;Charlie Bartlett;65;-12000000
2881;12400000;Comedy Drama;La grande bellezza;32523573;8371085;1420;The Great Beauty;73;-4028915
2882;0;Comedy Drama;The Dangerous Lives of Altar Boys;2,25E+16;0;1040;The Dangerous Lives of Altar Boys;64;0
2883;12000000;Drama Horror Thriller;Stoker;27322212;12077441;990;Stoker;65;77441
2884;12000000;Fantasy Drama Science Fiction Romance;2046;1,27E+16;19271312;1290;2046;69;7271312
2885;12000000;Crime Drama Romance;Married Life;3004432;0;900;Married Life;61;-12000000
2886;12000000;Adventure Drama Family;Duma;4795244;0;1000;Duma;69;-12000000
2887;12000000;Drama Romance;Ondine;5841285;1644755;1110;Ondine;65;-10355245
2888;12000000;Crime Drama Thriller;Brother;5327714;15250000;1140;Brother;68;3250000
2889;1200000;Comedy;Welcome to Collinwood;3582733;0;860;Welcome to Collinwood;62;-1200000
2890;0;Comedy Drama;Critical Care;2678715;0;1070;Critical Care;61;0
2891;8000000;Thriller Drama Mystery;The Life Before Her Eyes;9728143;0;900;The Life Before Her Eyes;61;-8000000
2892;0;Drama Romance;Darling Companion;2303865;0;1030;Darling Companion;53;0
2893;12000000;Drama Thriller;Trade;11237374;0;1200;Trade;68;-12000000
2894;0;War Drama;Sorstalanság;1906807;0;1400;Fateless;65;0
2895;12000000;Comedy;Breakfast of Champions;2695896;0;1100;Breakfast of Champions;52;-12000000
2896;0;Comedy Drama Thriller;三枪拍案惊奇;1416796;0;950;A Woman, a Gun and a Noodle Shop;48;0
2897;7500000;Thriller Science Fiction Mystery;Cypher;1,16E+16;0;950;Cypher;67;-7500000
2898;12000000;Drama History War;南京!南京!;4793348;10652498;1320;City of Life and Death;76;-1347502
2899;19000000;Animation Family Action Adventure Comedy;兔侠传奇;7,39E+15;2570000;890;Legend of a Rabbit;30;-16430000
2900;12000000;Science Fiction;Space Battleship Yamato;5158067;11212294;1310;Space Battleship Yamato;63;-787706
2901;20000000;War Drama;5 Days of War;5727602;17479;1130;5 Days of War;58;-19982521
2902;12000000;Horror;Triangle;2,55E+16;0;990;Triangle;69;-12000000
2903;1200000;Drama;10 Days in a Madhouse;489271;0;1110;10 Days in a Madhouse;43;-1200000
2904;12000000;Drama;Heaven is for Real;11150261;101332962;990;Heaven is for Real;60;89332962
2905;10000000;Thriller Crime;Snatch;53595686;83557872;1030;Snatch;77;73557872
2906;0;Drama Romance;Dancin' It's On;1,86E+16;0;890;Dancin' It's On;43;0
2907;11500000;Drama Horror;Pet Sematary;20747994;57469467;1030;Pet Sematary;64;45969467
2908;0;Drama;まあだだよ;2930853;0;1340;Madadayo;75;0
2909;11500000;Drama;The Cry of the Owl;475919;0;1010;The Cry of the Owl;55;-11500000
2910;0;Drama History Romance;三城记;753362;0;1300;A Tale of Three Cities;63;0
2911;11000000;Fantasy Horror Comedy;Gremlins;45072136;153083102;1060;Gremlins;69;142083102
2912;11000000;Adventure Action Science Fiction;Star Wars;126393695;775398007;1210;Star Wars;81;764398007
2913;11500000;Comedy;Dirty Grandpa;56805781;94073028;1020;Dirty Grandpa;57;82573028
2914;11000000;Drama Romance War;Doctor Zhivago;12854853;111858363;1970;Doctor Zhivago;74;100858363
2915;0;Adventure Crime Drama Thriller;Trash;1,46E+16;0;1120;Trash;71;0
2916;0;Comedy Drama Family Music Romance;High School Musical 3: Senior Year;21801188;0;1160;High School Musical 3: Senior Year;62;0
2917;25000000;Drama;The Fighter;31019381;93617009;1160;The Fighter;72;68617009
2918;11000000;Action Comedy Documentary;Jackass Number Two;11227087;72778712;950;Jackass Number Two;64;61778712
2919;11000000;Comedy Drama;My Cousin Vinny;19231507;64088552;1200;My Cousin Vinny;73;53088552
2920;11000000;Drama;If I Stay;31162838;78874843;1060;If I Stay;73;67874843
2921;12000000;Action Comedy Crime;Drive Hard;394487;0;960;Drive Hard;39;-12000000
2922;11000000;Comedy;Major League;7,56E+15;49797148;1070;Major League;66;38797148
2923;0;Comedy Family Science Fiction;St. Trinian's;7,38E+15;0;1010;St. Trinian's;56;0
2924;13000000;Thriller Drama;Phone Booth;38018085;97837138;810;Phone Booth;67;84837138
2925;11000000;Drama Romance;A Walk to Remember;3,33E+16;41227069;1010;A Walk to Remember;75;30227069
2926;11000000;Drama;Dead Man Walking;1,59E+16;39363635;1220;Dead Man Walking;73;28363635
2927;10500000;Drama Romance Thriller;Cruel Intentions;23449703;75902208;970;Cruel Intentions;66;65402208
2928;11000000;Horror Mystery;Saw VI;31900899;68233629;900;Saw VI;60;57233629
2929;11000000;Comedy;History of the World: Part I;1,43E+16;31672907;920;History of the World: Part I;65;20672907
2930;11000000;Adventure;The Secret Life of Bees;7645979;38105395;1140;The Secret Life of Bees;74;27105395
2931;11000000;Action Comedy Crime;Corky Romano;3,50E+16;23978402;860;Corky Romano;41;12978402
2932;12000000;Drama Horror Thriller Crime;Raising Cain;7558959;37170057;910;Raising Cain;59;25170057
2933;11;Drama Action;F.I.S.T.;3375208;11;1450;F.I.S.T.;64;0
2934;12000000;Science Fiction;Invaders from Mars;4234269;4884663;1000;Invaders from Mars;55;-7115337
2935;11000000;Drama Romance;Brooklyn;39337949;62076141;1110;Brooklyn;72;51076141
2936;11000000;Drama Romance War;Barry Lyndon;29543331;20000000;1840;Barry Lyndon;77;9000000
2937;24000000;Comedy;Out Cold;412064;14782676;890;Out Cold;58;-9217324
2938;24000000;Comedy;The Ladies Man;2259537;13700000;840;The Ladies Man;57;-10300000
2939;11000000;Drama Comedy Romance;Quartet;7,72E+16;59520298;980;Quartet;63;48520298
2940;11000000;Comedy Romance;Tomcats;7063053;23430766;950;Tomcats;49;12430766
2941;11000000;Drama Thriller Crime;Frailty;1,60E+16;13110448;1000;Frailty;70;2110448
2942;11000000;Drama;Woman in Gold;21204929;61619773;1200;Woman in Gold;73;50619773
2943;0;Drama;Kinsey;6799314;0;1180;Kinsey;66;0
2944;11000000;Fantasy Horror Comedy;Army of Darkness;33758281;0;810;Army of Darkness;73;-11000000
2945;14000000;Comedy Romance;Slackers;9371811;6413915;860;Slackers;54;-7586085
2946;11000000;Romance Drama;What's Eating Gilbert Grape;33282794;30000000;1180;What's Eating Gilbert Grape;75;19000000
2947;10000000;Drama History;The Visual Bible: The Gospel of John;3,21E+16;4069090;1250;The Visual Bible: The Gospel of John;82;-5930910
2948;11000000;Crime Drama;Vera Drake;4131918;0;1250;Vera Drake;68;-11000000
2949;0;Comedy Romance;The Guru;4,09E+15;0;910;The Guru;51;0
2950;11000000;Comedy Drama Romance;The Perez Family;1187671;2832826;1130;The Perez Family;66;-8167174
2951;11000000;Drama Music;Inside Llewyn Davis;36319205;32935319;1050;Inside Llewyn Davis;72;21935319
2952;0;Drama Romance Thriller;O;4,15E+15;16017403;950;O;58;16017403
2953;11000000;Drama Adventure Romance;Return to the Blue Lagoon;9705589;2807854;980;Return to the Blue Lagoon;51;-8192146
2954;11000000;Drama History;The Molly Maguires;1,40E+16;2200000;1240;The Molly Maguires;59;-8800000
2955;0;Comedy Music Romance;Romance & Cigarettes;4056774;2945242;1050;Romance & Cigarettes;60;2945242
2956;11000000;Drama;Copying Beethoven;5062687;0;1040;Copying Beethoven;62;-11000000
2957;0;Drama Thriller Crime;Brighton Rock;3,12E+16;0;1110;Brighton Rock;56;0
2958;10800000;Horror Thriller Crime;Saw V;3,29E+16;113857533;920;Saw V;59;103057533
2959;0;Drama Action Thriller Crime Foreign;Gli intoccabili;700127;0;1160;Machine Gun McCain;73;0
2960;11000000;Drama Comedy Romance;LOL;3,18E+16;0;970;LOL;59;-11000000
2961;0;Crime Drama Mystery Thriller;Jindabyne;8950864;0;1230;Jindabyne;57;0
2962;7400000;Drama Romance;कभी अलविदा ना कहना;3246903;17000000;1930;Kabhi Alvida Naa Kehna;61;9600000
2963;14000000;Drama Comedy Romance;An Ideal Husband;4519523;18535191;970;An Ideal Husband;63;4535191
2964;0;Science Fiction Thriller Horror;The Last Days on Mars;18764453;0;980;The Last Days on Mars;52;0
2965;0;Horror;Darkness;6340135;0;1020;Darkness;56;0
2966;10500000;Science Fiction Mystery Adventure;2001: A Space Odyssey;86201184;68700000;1490;2001: A Space Odyssey;79;58200000
2967;10500000;Science Fiction Adventure Family Fantasy;E.T. the Extra-Terrestrial;56105798;792910554;1150;E.T. the Extra-Terrestrial;73;782410554
2968;10000000;Romance Comedy Drama;In the Land of Women;12792446;17500000;970;In the Land of Women;58;7500000
2969;0;Adventure Drama Family;The Blue Butterfly;1985552;0;970;The Blue Butterfly;68;0
2970;10500000;Drama Comedy;There Goes My Baby;37073;123509;990;There Goes My Baby;85;-10376491
2971;0;Drama Comedy Romance Foreign;Housefull;1,21E+16;0;1350;Housefull;52;0
2972;11000000;Drama Action History Western Romance;September Dawn;3,65E+16;0;1100;September Dawn;50;-11000000
2973;12000000;History Drama;For Greater Glory - The True Story of Cristiada;5759545;9622846;1450;For Greater Glory - The True Story of Cristiada;64;-2377154
2974;11000000;Comedy Drama Music;La Famille Bélier;25302978;0;1050;The Bélier Family;70;-11000000
2975;10000000;Drama;Good Will Hunting;4,37E+16;225933435;1260;Good Will Hunting;79;215933435
2976;11000000;Drama Thriller;Misconduct;10016909;0;1060;Misconduct;53;-11000000
2977;10000000;Horror Thriller Crime;Saw III;33124871;163876815;1080;Saw III;61;153876815
2978;10000000;Action Comedy;Stripes;10892398;85300000;1060;Stripes;65;75300000
2979;28000000;Comedy;Bring It On;14754281;90449929;980;Bring It On;58;62449929
2980;10000000;Action Horror Thriller;The Purge: Election Year;53727146;118587880;1050;The Purge: Election Year;61;108587880
2981;10000000;Comedy Romance;She's All That;89876;103166989;950;She's All That;57;93166989
2982;10000000;Horror Thriller Crime;Saw IV;29244768;139352633;930;Saw IV;59;129352633
2983;10000000;Drama Horror Thriller;White Noise;1,44E+16;91196419;1010;White Noise;56;81196419
2984;6000000;Drama Comedy Romance;Madea's Family Reunion;5882208;57231524;1100;Madea's Family Reunion;60;51231524
2985;13800000;Drama;The Color of Money;173393;52293982;1190;The Color of Money;67;38493982
2986;10000000;Action Drama History War;The Longest Day;19524972;50100000;1780;The Longest Day;72;40100000
2987;10000000;Comedy Family;The Mighty Ducks;8932837;50752337;1010;The Mighty Ducks;64;40752337
2988;10000000;Horror Mystery Thriller;The Grudge;35695442;183474602;920;The Grudge;58;173474602
2989;12000000;Comedy;Happy Gilmore;26598884;41205099;920;Happy Gilmore;65;29205099
2990;10000000;Horror Thriller;Jeepers Creepers;23316208;59217789;900;Jeepers Creepers;61;49217789
2991;10000000;Adventure Comedy Science Fiction;Bill & Ted's Excellent Adventure;25929893;40485039;900;Bill & Ted's Excellent Adventure;67;30485039
2992;10000000;Drama Family Music;Oliver!;8,31E+15;37402877;1530;Oliver!;70;27402877
2993;10000000;Drama Comedy;The Best Exotic Marigold Hotel;21258991;136836156;1240;The Best Exotic Marigold Hotel;69;126836156
2994;10000000;Science Fiction Animation Comedy Family;Recess: School's Out;5699058;44460850;830;Recess: School's Out;66;34460850
2995;12305523;Action Adventure Science Fiction;Mad Max Beyond Thunderdome;36582038;36230219;1070;Mad Max Beyond Thunderdome;59;23924696
2996;10000000;Action Adventure Thriller;Commando;34224204;57500000;900;Commando;64;47500000
2997;10000000;Horror Mystery Thriller;The Boy;3,82E+15;64188367;970;The Boy;58;54188367
2998;10000000;Horror Mystery Thriller;Devil;30934688;33583175;800;Devil;58;23583175
2999;20000000;Comedy;Friday After Next;7499639;33526835;850;Friday After Next;60;13526835
3000;10000000;Drama Horror Thriller;Insidious: Chapter 3;45946524;104303851;970;Insidious: Chapter 3;62;94303851
3001;10000000;Action Adventure Comedy;The Last Dragon;4,93E+15;25754284;1080;The Last Dragon;64;15754284
3002;10000000;Horror Thriller Science Fiction;The Lawnmower Man;10125029;32101000;1080;The Lawnmower Man;54;22101000
3003;9000000;Comedy Music Romance;Nick and Norah's Infinite Playlist;2,05E+16;32973937;890;Nick and Norah's Infinite Playlist;64;23973937
3004;10000000;Fantasy Comedy Adventure;Dogma;14543435;30652890;1300;Dogma;68;20652890
3005;10000000;Comedy Drama;The Banger Sisters;6015354;0;980;The Banger Sisters;55;-10000000
3006;10000000;Drama Fantasy Horror Science Fiction Thriller;Twilight Zone: The Movie;12902975;29450919;1010;Twilight Zone: The Movie;62;19450919
3007;15000000;Action Thriller;Road House;6216203;30050028;1140;Road House;63;15050028
3008;10000000;Action Comedy Crime;A Low Down Dirty Shame;3290639;29392418;1000;A Low Down Dirty Shame;60;19392418
3009;8500000;Drama Thriller;Swimfan;4844451;34411240;840;Swimfan;50;25911240
3010;12000000;Comedy Romance;Employee of the Month;9559737;38368909;1030;Employee of the Month;53;26368909
3011;10000000;Comedy Drama Romance;Can't Hardly Wait;1,14E+16;25605015;1000;Can't Hardly Wait;61;15605015
3012;10000000;Crime Drama;The Outsiders;1,35E+16;33697647;910;The Outsiders;69;23697647
3013;65000000;Adventure Family Fantasy;Pete's Dragon;3,20E+16;143695338;1020;Pete's Dragon;62;78695338
3014;10000000;Horror Science Fiction Thriller;The Dead Zone;1,68E+16;20766616;1030;The Dead Zone;69;10766616
3015;10000000;Horror;Sinister 2;26090495;52882018;970;Sinister 2;54;42882018
3016;14000000;Drama Music;Sparkle;2698185;24637469;1160;Sparkle;58;10637469
3017;0;Horror Thriller;Valentine;5904126;0;960;Valentine;50;0
3018;10000000;Mystery Science Fiction Thriller;The Fourth Kind;2,29E+16;42333295;980;The Fourth Kind;58;32333295
3019;10000000;Drama Comedy Music;A Prairie Home Companion;5025446;0;1050;A Prairie Home Companion;64;-10000000
3020;0;Drama Action Thriller;Sugar Hill;2580808;0;1230;Sugar Hill;52;0
3021;0;Action Thriller;Invasion U.S.A.;4192064;0;1070;Invasion U.S.A.;53;0
3022;0;Comedy Drama Family;Roll Bounce;2,60E+16;0;1120;Roll Bounce;61;0
3023;9000000;Comedy Drama;Rushmore;18289303;17096053;930;Rushmore;75;8096053
3024;10000000;Science Fiction;Skyline;2,63E+16;66821036;1000;Skyline;47;56821036
3025;10000000;Drama Comedy;The Second Best Exotic Marigold Hotel;17592299;85978266;1220;The Second Best Exotic Marigold Hotel;63;75978266
3026;0;Comedy Drama Family;Kit Kittredge: An American Girl;6,27E+16;0;1010;Kit Kittredge: An American Girl;64;0
3027;0;Comedy Drama Family Romance;The Perfect Man;11158906;0;1000;The Perfect Man;55;0
3028;10000000;Drama Romance;Mo' Better Blues;3079862;16153593;1290;Mo' Better Blues;63;6153593
3029;0;Action Comedy;Kung Pow: Enter the Fist;;;;;;0
;; Oedekerk sets off to avenge the deaths of his parents at the hands of kung-fu legend Master Pain. Along the way;25/01/2002;810;;61;Steve Oedekerk;;0
3030;11000000;Action Horror;Tremors;3,26E+16;48572000;960;Tremors;66;37572000
3031;12600000;Horror Thriller;Wrong Turn;33555764;28650575;840;Wrong Turn;60;16050575
3032;10000000;Western History;The Long Riders;2959547;15795189;990;The Long Riders;66;5795189
3033;25000000;Action Crime Mystery Thriller;The Corruptor;4068107;15156200;1100;The Corruptor;60;-9843800
3034;10000000;Drama;Mud;17663353;21587700;1300;Mud;70;11587700
3035;10000000;Action Adventure Comedy Crime;Reno 911!: Miami;4207456;20342161;840;Reno 911!: Miami;56;10342161
3036;10000000;Documentary Music;One Direction: This Is Us;7,94E+15;0;920;One Direction: This Is Us;80;-10000000
3037;10000000;Comedy;The Goods: Live Hard, Sell Hard;3352702;0;900;The Goods: Live Hard, Sell Hard;54;-10000000
3038;0;Animation Family;Hey Arnold! The Movie;5856363;0;760;Hey Arnold! The Movie;56;0
3039;6400000;Drama;My Week with Marilyn;21006078;35057696;990;My Week with Marilyn;66;28657696
3040;10000000;Action Comedy Crime Drama Thriller;The Matador;5647538;17297244;960;The Matador;62;7297244
3041;10000000;Comedy Drama Romance;Love Jones;1000178;0;1040;Love Jones;81;-10000000
3042;5000000;Thriller Mystery;The Gift;27247013;58978653;1080;The Gift;67;53978653
3043;0;Adventure Drama;End of the Spear;183428;0;1080;End of the Spear;61;0
3044;10000000;Comedy Romance;Get Over It;11592129;0;870;Get Over It;55;-10000000
3045;10000000;Comedy Crime;Office Space;18366362;12827813;890;Office Space;74;2827813
3046;10000000;Comedy;Drop Dead Gorgeous;6,74E+15;10571408;980;Drop Dead Gorgeous;64;571408
3047;10000000;Drama;Big Eyes;2,86E+16;28883511;1050;Big Eyes;68;18883511
3048;30000000;Comedy Crime Thriller;Very Bad Things;5671691;9898412;1000;Very Bad Things;62;-20101588
3049;0;Comedy Family;Sleepover;5842299;0;890;Sleepover;53;0
3050;10000000;Crime Mystery Horror Thriller;Body Double;9,53E+15;8801940;1140;Body Double;64;-1198060
3051;10000000;Action Adventure Comedy;MacGruber;1,40E+16;6110000;900;MacGruber;51;-3890000
3052;0;Crime Drama Thriller;Dirty Pretty Things;9177896;0;970;Dirty Pretty Things;68;0
3053;6000000;Comedy;Movie 43;3,54E+15;32438988;900;Movie 43;44;26438988
3054;10000000;Comedy;Over Her Dead Body;12067921;0;950;Over Her Dead Body;53;-10000000
3055;10000000;Comedy Drama Romance Science Fiction;Seeking a Friend for the End of the World;3,09E+16;9636289;1010;Seeking a Friend for the End of the World;63;-363711
3056;0;Comedy;Cedar Rapids;1,03E+16;6861102;870;Cedar Rapids;59;6861102
3057;20000000;Drama;American History X;7,36E+15;23875127;1190;American History X;82;3875127
3058;0;Horror Thriller;The Collection;16361743;6842058;940;The Collection;59;6842058
3059;10000000;Animation Drama Family Music;Teacher's Pet;1374409;0;740;Teacher's Pet;55;-10000000
3060;18000000;Drama Thriller Mystery Music Romance;The Red Violin;618869;9495408;1310;The Red Violin;73;-8504592
3061;10000000;Drama;The Straight Story;15280261;0;1120;The Straight Story;77;-10000000
3062;0;Action Crime Drama Romance;Deuces Wild;7,53E+15;0;960;Deuces Wild;55;0
3063;9500000;Comedy;Bad Words;1,41E+16;7800000;880;Bad Words;64;-1700000
3064;10000000;Comedy Romance;Run Fatboy Run;14905357;33000000;1000;Run, Fatboy, Run;62;23000000
3065;10000000;Comedy Romance Family;Heartbeeps;5,18E+15;2154696;790;Heartbeeps;38;-7845304
3066;9000000;Drama;Black or White;12172131;21571189;1210;Black or White;65;12571189
3067;0;Comedy Family Romance;On the Line;3084874;0;850;On the Line;41;0
3068;10000000;Adventure Drama War;Rescue Dawn;17078656;7177143;1260;Rescue Dawn;69;-2822857
3069;10000000;Comedy Drama Music;Danny Collins;1,63E+16;10835752;1070;Danny Collins;66;835752
3070;10000000;Drama Comedy;Jeff, Who Lives at Home;10409155;4417580;830;Jeff, Who Lives at Home;61;-5582420
3071;0;Drama Romance;Io sono l'amore;5355763;0;1200;I Am Love;69;0
3072;0;Drama Science Fiction Mystery;Atlas Shrugged Part II;4725357;0;1120;Atlas Shrugged Part II;54;0
3073;11500000;Action Crime Drama Thriller;Romeo Is Bleeding;4850402;3275585;1000;Romeo Is Bleeding;57;-8224415
3074;10000000;Action Crime Drama Mystery Thriller;The Limey;8,90E+15;3193102;890;The Limey;66;-6806898
3075;6500000;Drama;Crash;28223163;98410061;1120;Crash;72;91910061
3076;10000000;Drama Romance;The House of Mirth;3007816;5164404;1400;The House of Mirth;64;-4835596
3077;0;Action Thriller;Malone;1610132;0;920;Malone;68;0
3078;0;Drama Romance;Peaceful Warrior;8326131;0;1200;Peaceful Warrior;73;0
3079;10000000;Comedy;Bucky Larson: Born to Be a Star;3919057;0;970;Bucky Larson: Born to Be a Star;44;-10000000
3080;0;Comedy Drama;Bamboozled;223411;0;1350;Bamboozled;63;0
3081;10000000;Horror Thriller;The Forest;1,99E+16;40055439;950;The Forest;48;30055439
3082;14000000;Adventure Mystery Thriller;Sphinx;310513;439564;1180;Sphinx;60;-13560436
3083;10000000;Comedy Drama Mystery;While We're Young;1,93E+16;7587485;970;While We're Young;58;-2412515
3084;10000000;Drama;A Better Life;4123533;1759252;980;A Better Life;70;-8240748
3085;0;Drama Mystery Thriller;Spider;6948401;0;980;Spider;64;0
3086;10000000;Action Comedy Romance Thriller;Gun Shy;3988432;1631839;1010;Gun Shy;54;-8368161
3087;0;Adventure Drama Action Family;Nicholas Nickleby;5099923;0;1320;Nicholas Nickleby;68;0
3088;20000000;Thriller Crime Drama;The Iceman;19494703;1969193;1050;The Iceman;64;-18030807
3089;0;Action Science Fiction;कृष;3759988;0;1540;Krrish;55;0
3090;10000000;Thriller Comedy Crime;Cecil B. Demented;4,18E+16;0;870;Cecil B. Demented;62;-10000000
3091;10000000;Crime Drama Thriller;Killer Joe;1,64E+16;3665069;1020;Killer Joe;65;-6334931
3092;10000000;Comedy Drama;The Joneses;14979375;7022728;960;The Joneses;61;-2977272
3093;0;Crime Drama Thriller;Owning Mahowny;8045488;0;1040;Owning Mahowny;68;0
3094;0;Comedy;The Brothers Solomon;8312153;0;930;The Brothers Solomon;49;0
3095;10000000;Drama Romance;My Blueberry Nights;10733761;21786738;1110;My Blueberry Nights;60;11786738
3096;0;Drama;Illuminata;1,11E+16;0;1190;Illuminata;63;0
3097;10000000;Comedy Romance;Swept Away;4570043;598645;890;Swept Away;48;-9401355
3098;5000000;Action Adventure Comedy Thriller;War, Inc.;6,27E+15;1296184;1060;War, Inc.;56;-3703816
3099;0;Action Comedy;少林足球;1754768;42776760;1130;Shaolin Soccer;66;42776760
3100;10000000;Drama;The Brown Bunny;3,41E+16;0;930;The Brown Bunny;55;-10000000
3101;0;Comedy Crime Thriller;Rien ne va plus;6,28E+15;0;1050;The Swindle;64;0
3102;0;Drama;Rosewater;575555;0;1030;Rosewater;65;0
3103;0;Drama;La femme de chambre du Titanic;1031142;0;1000;The Chambermaid on the Titanic;53;0
3104;7700000;Drama Thriller;Coriolanus;7,55E+15;1072602;1230;Coriolanus;59;-6627398
3105;10000000;Comedy Drama;Imaginary Heroes;285283;0;1110;Imaginary Heroes;63;-10000000
3106;0;Action Crime Comedy;High Heels and Low Lifes;1769593;0;860;High Heels and Low Lifes;64;0
3107;10000000;Comedy Romance;World's Greatest Dad;9805551;295750;990;World's Greatest Dad;65;-9704250
3108;0;Horror Comedy Thriller;Severance;12898984;0;960;Severance;64;0
3109;10000000;Drama Thriller;Edmond;2803642;0;820;Edmond;60;-10000000
3110;0;Drama;Welcome to the Rileys;6085879;42145;1100;Welcome to the Rileys;64;42145
3111;0;Comedy Crime;Police Academy: Mission to Moscow;11946898;126247;830;Police Academy: Mission to Moscow;41;126247
3112;0;Drama Crime;Blood Done Sign My Name;397341;0;0;Blood Done Sign My Name;60;0
3113;10000000;War History Drama;Cinco de Mayo: La Batalla;72085;0;1250;Cinco de Mayo: La Batalla;58;-10000000
3114;10000000;Comedy Family Romance;Elsa & Fred;2849895;0;1040;Elsa & Fred;62;-10000000
3115;10000000;Comedy;An Alan Smithee Film: Burn, Hollywood, Burn;666218;45779;860;An Alan Smithee Film: Burn, Hollywood, Burn;30;-9954221
3116;0;Comedy Drama Romance;The Open Road;1388136;0;900;The Open Road;48;0
3117;3200000;Comedy Romance;The Good Guy;2631688;0;900;The Good Guy;54;-3200000
3118;0;Comedy Drama;Motherhood;10955567;0;900;Motherhood;47;0
3119;0;Drama Family;Free Style;122874;140987;940;Free Style;58;140987
3120;10000000;Drama Thriller;Strangerland;5,15E+16;17472;1110;Strangerland;51;-9982528
3121;10000000;Comedy;Janky Promoters;1728816;9069;850;Janky Promoters;70;-9990931
3122;10000000;Comedy Romance;Blonde Ambition;3064563;0;930;Blonde Ambition;39;-10000000
3123;14100000;Crime Mystery Thriller;The Oxford Murders;9318033;0;1070;The Oxford Murders;57;-14100000
3124;0;Drama Horror Thriller;The Reef;7245108;0;940;The Reef;54;0
3125;0;Comedy Drama;Eulogy;9085482;0;910;Eulogy;64;0
3126;0;Thriller Drama Horror Fantasy;White Noise 2: The Light;6814247;0;990;White Noise 2: The Light;56;0
3127;10000000;Music Drama;Beat the World;2873796;0;910;Beat the World;43;-10000000
3128;0;Action Thriller;Fifty Dead Men Walking;4481897;0;1170;Fifty Dead Men Walking;61;0
3129;0;Family Animation Adventure;Jungle Shuffle;1413934;0;850;Jungle Shuffle;65;0
3130;10000000;Drama War;Adam Resurrected;2574014;0;1060;Adam Resurrected;64;-10000000
3131;10;Drama Romance Comedy;Hross í oss;1,62E+16;11;850;Of Horses and Men;69;1
3132;0;Comedy Romance;Hai Marjawaan!;1259968;0;990;It's a Wonderful Afterlife;43;0
3133;10000000;Action Horror Thriller Science Fiction;The Devil's Tomb;5,10E+16;0;900;The Devil's Tomb;40;-10000000
3134;0;Drama Foreign Romance;Partition;2131524;0;1160;Partition;64;0
3135;0;Comedy;Good Intentions;304566;0;850;Good Intentions;50;0
3136;10000000;Action Adventure Comedy Western;좋은 놈, 나쁜 놈, 이상한 놈;11847324;0;1300;The Good, The Bad, The Weird;71;-10000000
3137;10;Horror Thriller;Nurse 3-D;10013629;10000000;990;Nurse 3-D;49;9999990
3138;10000000;Drama Action Comedy Western;Gunless;3753703;0;890;Gunless;67;-10000000
3139;9500000;Comedy;Adventureland;19978021;17164377;1070;Adventureland;64;7664377
3140;9600000;Drama Romance;The Lost City;3,59E+16;4386236;1440;The Lost City;60;-5213764
3141;11000000;Comedy;Next Friday;9337388;59827328;980;Next Friday;64;48827328
3142;10000000;Action;American Heist;11431434;0;940;American Heist;43;-10000000
3143;9500000;Action Thriller Adventure;You Only Live Twice;2,87E+16;111584787;1170;You Only Live Twice;65;102084787
3144;10;Drama Action Comedy Crime;Plastic;9,70E+15;0;1020;Plastic;61;-10
3145;8900000;Drama Romance;Amour;17151293;19839492;1270;Amour;75;10939492
3146;10500000;Horror Thriller;Poltergeist III;11225044;14144000;980;Poltergeist III;45;3644000
3147;9500000;Horror Science Fiction;Re-Kill;5346205;0;870;Re-Kill;49;-9500000
3148;9400000;Action Adventure Comedy Crime;It's a Mad, Mad, Mad, Mad World;14562991;60000000;1630;It's a Mad, Mad, Mad, Mad World;70;50600000
3149;12899867;Comedy Drama Romance;Volver;19747809;85582407;1210;Volver;73;72682540
3150;9300000;Animation Science Fiction;Heavy Metal;12928269;0;900;Heavy Metal;62;-9300000
3151;10000000;Action Comedy Thriller;Gentlemen Broncos;3193777;0;890;Gentlemen Broncos;62;-10000000
3152;0;Drama War;Richard III;5107235;0;1040;Richard III;69;0
3153;10000000;Action Horror Thriller;Into the Grizzly Maze;1,01E+16;0;940;Into the Grizzly Maze;51;-10000000
3154;0;Drama Action Romance;Kites;4807549;0;1310;Kites;60;0
3155;7400000;Drama Science Fiction;Melancholia;36173598;21817298;1360;Melancholia;70;14417298
3156;0;Drama Comedy Family;Red Dog;5499412;0;920;Red Dog;71;0
3157;0;Drama Romance;Jab Tak Hai Jaan;5900535;0;1760;Jab Tak Hai Jaan;73;0
3158;11000000;Horror Action Thriller Science Fiction;Alien;94184658;104931801;1170;Alien;79;93931801
3159;85000;Horror;The Texas Chain Saw Massacre;2,93E+16;30859000;830;The Texas Chain Saw Massacre;72;30774000
3160;10000000;Drama Music;The Runaways;17611971;2995811;1060;The Runaways;63;-7004189
3161;9000000;Drama Romance;Fiddler on the Roof;7,62E+16;83304330;1810;Fiddler on the Roof;74;74304330
3162;5500000;Adventure Action Thriller;Thunderball;3,10E+16;141195658;1300;Thunderball;65;135695658
3163;10000000;Horror Comedy Science Fiction;Detention;1,04E+16;0;930;Detention;57;-10000000
3164;7000000;Comedy Drama Romance;Mine vaganti;7720692;8220215;1100;Loose Cannons;70;1220215
3165;9000000;Drama Action Crime;Set It Off;6717994;41590886;1180;Set It Off;69;32590886
3166;9000000;Drama Comedy;The Best Man;3,95E+15;34573780;1200;The Best Man;68;25573780
3167;9000000;Horror Thriller;Child's Play;2,76E+16;44196684;870;Child's Play;63;35196684
3168;9000000;Documentary;Sicko;1,41E+16;24538513;1230;Sicko;73;15538513
3169;9000000;Horror Thriller;The Purge: Anarchy;82975841;108782847;1040;The Purge: Anarchy;66;99782847
3170;9000000;Comedy Drama Family Romance;Down to You;3269459;0;910;Down to You;49;-9000000
3171;9000000;Comedy Adventure;Harold & Kumar Go to White Castle;18514292;23936908;880;Harold & Kumar Go to White Castle;66;14936908
3172;9000000;Drama Thriller;The Contender;7029126;0;1260;The Contender;67;-9000000
3173;26000000;Crime Drama Thriller;Boiler Room;11233081;28780255;1180;Boiler Room;65;2780255
3174;40600000;Comedy;Trading Places;3,40E+16;90400000;1160;Trading Places;71;49800000
3175;9000000;Horror Thriller;Black Christmas;4134327;21510851;840;Black Christmas;48;12510851
3176;0;Comedy Romance;Breakin' All the Rules;6,90E+16;0;850;Breakin' All the Rules;58;0
3177;9000000;War Drama History Action Romance;Henry V;4641006;0;1370;Henry V;74;-9000000
3178;0;Drama;The Savages;5663889;0;1140;The Savages;68;0
3179;0;Comedy Romance;Chasing Papi;1118511;6126237;800;Chasing Papi;63;6126237
3180;8500000;Action Crime Drama Thriller;The Way of the Gun;8,78E+15;19125401;1190;The Way of the Gun;64;10625401
3181;9000000;Comedy Drama;Igby Goes Down;2062087;4777465;970;Igby Goes Down;65;-4222535
3182;9000000;Comedy;PCU;8738737;4350774;790;PCU;60;-4649226
3183;0;Romance Drama Family;The Ultimate Gift;4976268;0;1140;The Ultimate Gift;68;0
3184;9000000;Action Science Fiction Comedy;The Ice Pirates;3,81E+16;0;910;The Ice Pirates;57;-9000000
3185;9000000;Drama;Gracie;2365328;2955039;970;Gracie;60;-6044961
3186;9000000;Comedy Drama Romance;Trust the Man;52545;0;1030;Trust the Man;55;-9000000
3187;0;Comedy Music;Hamlet 2;5,29E+15;0;920;Hamlet 2;61;0
3188;0;Drama Music;Velvet Goldmine;10932711;1053788;1190;Velvet Goldmine;69;1053788
3189;0;Horror Mystery;곡성;9,05E+15;0;1560;The Wailing;72;0
3190;9000000;Documentary Music Family;Glee: The Concert Movie;9933926;18663238;840;Glee: The Concert Movie;68;9663238
3191;0;Drama Foreign History War;สุริโยไท;843067;0;1850;The Legend of Suriyothai;51;0
3192;9000000;Horror Thriller;Due occhi diabolici;8218383;0;1200;Two Evil Eyes;60;-9000000
3193;6000000;Comedy;Barbecue;5119593;14348529;980;Barbecue;58;8348529
3194;9000000;Comedy Drama;All or Nothing;2872281;0;1280;All or Nothing;70;-9000000
3195;9000000;Drama;Princess Kaiulani;717811;771499;1300;Princess Kaiulani;48;-8228501
3196;5000000;Drama Family Foreign;Opal Dream;1458884;140666;860;Opal Dream;61;-4859334
3197;6500000;Crime Drama History War;Flammen & Citronen;7028946;0;1300;Flame & Citron;68;-6500000
3198;9000000;Comedy Romance;Undiscovered;2,01E+16;1046166;970;Undiscovered;45;-7953834
3199;0;Thriller Mystery Crime Drama;Red Riding: In the Year of Our Lord 1974;7,25E+15;0;1020;Red Riding: In the Year of Our Lord 1974;70;0
3200;0;Drama Romance;La Fille du RER;2351706;0;1050;The Girl on the Train;56;0
3201;9000000;Drama Romance;Veronika Decides to Die;4799022;0;1030;Veronika Decides to Die;58;-9000000
3202;5000000;Adventure Comedy;Crocodile Dundee;16072466;328203506;970;Crocodile Dundee;63;323203506
3203;0;Animation Science Fiction;Ultramarines: A Warhammer 40,000 Movie;3,89E+16;0;760;Ultramarines: A Warhammer 40,000 Movie;52;0
3204;8800000;Thriller Mystery Science Fiction;The I Inside;3789485;0;900;The I Inside;59;-8800000
3205;7347125;Drama History War;Beneath Hill 60;3949796;0;1220;Beneath Hill 60;73;-7347125
3206;0;Drama;Polisse;14038703;20374201;1270;Polisse;79;20374201
3207;86000000;Thriller Crime Mystery;Awake;1,82E+16;14373825;840;Awake;63;-71626175
3208;0;Action Adventure Animation Fantasy Science Fiction;Star Wars: Clone Wars (Volume 1);1881466;0;690;Star Wars: Clone Wars: Volume 1;80;0
3209;9000000;Thriller Action Drama;Skin Trade;6,68E+15;0;960;Skin Trade;56;-9000000
3210;8500000;Horror Comedy;The Lost Boys;24750909;32222567;970;The Lost Boys;68;23722567
3211;7000000;Drama Music Romance;Crazy Heart;17697042;39462438;1120;Crazy Heart;68;32462438
3212;9250000;Drama Music Romance;The Rose;7000949;29174648;1250;The Rose;68;19924648
3213;8500000;Comedy;Baggage Claim;11436405;22456509;960;Baggage Claim;56;13956509
3214;9000000;Science Fiction;Barbarella;14171759;2500000;980;Barbarella;57;-6500000
3215;0;Adventure Family;Håkon Håkonsen;702971;0;920;Shipwrecked;61;0
3216;0;Comedy;Election;1,35E+16;0;990;Election;67;0
3217;12000000;Drama;The Namesake;3604863;20138836;1220;The Namesake;68;8138836
3218;8500000;Romance Comedy;The DUFF;4028709;43528634;1000;The DUFF;68;35028634
3219;22000000;Drama Romance;Glitter;3809131;5271666;1040;Glitter;34;-16728334
3220;0;Horror Drama Thriller;The Haunting in Connecticut 2: Ghosts of Georgia;11708343;0;1010;The Haunting in Connecticut 2: Ghosts of Georgia;56;0
3221;8000000;Action Drama History;실미도;260632;0;1350;Silmido;66;-8000000
3222;8500000;Drama Romance;Bright Star;9,23E+15;4440055;1190;Bright Star;68;-4059945
3223;12000000;Drama Romance;My Name Is Khan;1,47E+16;42345360;1450;My Name Is Khan;77;30345360
3224;9000000;Action Adventure Drama;All Is Lost;28540614;6108720;1060;All Is Lost;66;-2891280
3225;8000000;Adventure Drama Thriller;Limbo;34259;1997807;1260;Limbo;70;-6002193
3226;0;Drama Foreign Romance;Namastey London;1840511;0;1280;Namastey London;66;0
3227;6500000;Drama History War;The Wind That Shakes the Barley;6787967;22889018;1240;The Wind That Shakes the Barley;71;16389018
3228;7700000;Romance;Yeh Jawaani Hai Deewani;3,35E+16;46000000;1590;Yeh Jawaani Hai Deewani;72;38300000
3229;8250000;Drama History Romance;Quo Vadis;7973109;30000000;1710;Quo Vadis;70;21750000
3230;0;Horror Comedy Music Science Fiction;Repo! The Genetic Opera;5897479;188126;980;Repo! The Genetic Opera;67;188126
3231;10000000;Adventure Drama Action;Kurtlar vadisi - Irak;1465762;0;1220;Valley of the Wolves: Iraq;43;-10000000
3232;8000000;Thriller Crime;Pulp Fiction;121463076;213928762;1540;Pulp Fiction;83;205928762
3233;0;Adventure Comedy Family;The Muppet Movie;10639916;76657000;970;The Muppet Movie;70;76657000
3234;8500000;Crime Drama Thriller;Nightcrawler;89095538;38697217;1170;Nightcrawler;76;30197217
3235;8500000;Comedy Horror;Club Dread;262082;5001655;1040;Club Dread;51;-3498345
3236;8200000;Drama Family Music Romance;The Sound of Music;37960289;286214286;1740;The Sound of Music;74;278014286
3237;8000000;Comedy Fantasy Romance;Splash;21735068;69821334;1110;Splash;61;61821334
3238;8000000;Comedy Drama;Little Miss Sunshine;1,48E+16;100523181;1020;Little Miss Sunshine;75;92523181
3239;8000000;Crime Drama;Stand by Me;51109279;52287414;890;Stand by Me;78;44287414
3240;5000000;Horror Thriller Science Fiction;28 Days Later;4,55E+16;82719885;1130;28 Days Later;71;77719885
3241;0;Drama;You Got Served;3,80E+16;0;950;You Got Served;48;0
3242;8000000;Crime Drama;Escape from Alcatraz;2,64E+16;43000000;1110;Escape from Alcatraz;72;35000000
3243;8000000;Comedy Romance;Brown Sugar;3501158;27362712;1090;Brown Sugar;70;19362712
3244;0;Comedy Thriller Crime Romance;A Thin Line Between Love and Hate;2,09E+16;0;1080;A Thin Line Between Love and Hate;57;0
3245;8000000;Comedy Drama;50/50;3,34E+16;39187783;1000;50/50;70;31187783
3246;0;Horror Mystery Thriller;Shutter;8,86E+15;0;850;Shutter;53;0
3247;8000000;Comedy Romance;That Awkward Moment;37821106;26049082;940;That Awkward Moment;61;18049082
3248;0;Comedy;Modern Problems;4,29E+15;0;890;Modern Problems;56;0
3249;0;Adventure;Kicks;3,47E+16;0;800;Kicks;75;0
3250;8000000;Drama Comedy Romance;Much Ado About Nothing;1,02E+16;0;1110;Much Ado About Nothing;72;-8000000
3251;6500000;Adventure Action Thriller;On Her Majesty's Secret Service;25289665;81974493;1420;On Her Majesty's Secret Service;65;75474493
3252;14000000;Horror Thriller Mystery Fantasy;New Nightmare;14730796;18090181;1120;New Nightmare;64;4090181
3253;8000000;Drama Comedy Romance Family;Drive Me Crazy;4482714;22593409;910;Drive Me Crazy;58;14593409
3254;8000000;Drama;Akeelah and the Bee;4932893;18948425;1120;Akeelah and the Bee;67;10948425
3255;8000000;Comedy Crime;Half Baked;7894489;17460020;820;Half Baked;64;9460020
3256;8000000;Comedy;New in Town;13987772;29010817;970;New in Town;52;21010817
3257;7000000;Thriller Drama Crime;American Psycho;45310443;34266564;1020;American Psycho;73;27266564
3258;8000000;Drama Comedy Romance;The Good Girl;9799177;16856124;930;The Good Girl;61;8856124
3259;8000000;Action Comedy Crime;Bon Cop Bad Cop;5069095;12671300;1160;Bon Cop Bad Cop;65;4671300
3260;8000000;Action Thriller Crime;The Boondock Saints II: All Saints Day;1,35E+16;10629321;1180;The Boondock Saints II: All Saints Day;59;2629321
3261;0;Drama;The City of Your Final Destination;1,35E+16;0;1140;The City of Your Final Destination;57;0
3262;0;Comedy Drama Romance;Enough Said;1,50E+16;25288872;930;Enough Said;66;25288872
3263;8000000;Comedy;Easy A;45395839;74952305;920;Easy A;67;66952305
3264;0;Comedy Drama Romance;The Inkwell;2,70E+16;8880705;1100;The Inkwell;39;8880705
3265;8000000;Drama Horror;Shadow of the Vampire;593923;8279017;920;Shadow of the Vampire;66;279017
3266;8000000;Comedy;Prom;11837067;10130000;1040;Prom;57;2130000
3267;8000000;Comedy Romance;The Pallbearer;2149469;0;970;The Pallbearer;46;-8000000
3268;0;Comedy;Held Up;1,57E+16;0;890;Held Up;49;0
3269;8000000;Comedy Drama Romance;Woman on Top;3535789;0;920;Woman on Top;55;-8000000
3270;0;Drama Romance;Howards End;5,90E+16;25966555;1400;Howards End;69;25966555
3271;8000000;Animation Comedy Drama Romance;Anomalisa;2,10E+16;5659286;900;Anomalisa;70;-2340714
3272;8000000;Comedy Drama;Another Year;7235794;18124262;1290;Another Year;70;10124262
3273;8000000;Comedy Thriller Music Crime Mystery;8 femmes;8204829;0;1110;8 Women;69;-8000000
3274;8000000;Action Thriller;Showdown in Little Tokyo;8,40E+15;2275557;790;Showdown in Little Tokyo;57;-5724443
3275;0;Comedy Crime Drama Thriller;Clay Pigeons;4,22E+15;0;1040;Clay Pigeons;63;0
3276;8000000;Comedy Drama;It's Kind of a Funny Story;13143045;6491240;1010;It's Kind of a Funny Story;69;-1508760
3277;7200000;Comedy Drama History;Made in Dagenham;6138802;0;1130;Made in Dagenham;66;-7200000
3278;0;Drama;And When Did You Last See Your Father?;1939054;92;920;When Did You Last See Your Father?;69;92
3279;8000000;Drama Romance;Prefontaine;8717235;589304;1060;Prefontaine;67;-7410696
3280;0;Drama Adventure;The Wicked Lady;289433;0;980;The Wicked Lady;43;0
3281;0;Animation Family Fantasy;The Secret of Kells;10621353;0;750;The Secret of Kells;73;0
3282;8000000;Comedy Music Romance Drama;Begin Again;35735689;63464861;1040;Begin Again;73;55464861
3283;8000000;Drama Romance;Down in the Valley;7433574;852872;1120;Down in the Valley;59;-7147128
3284;8000000;Drama Action Thriller;Brooklyn Rules;4090382;458232;990;Brooklyn Rules;58;-7541768
3285;0;TV Movie Romance Drama;Restless;812776;0;1800;Restless;49;0
3286;0;Comedy Music Mystery Crime;The Singing Detective;6335881;0;1090;The Singing Detective;59;0
3287;0;Drama Romance War;The Land Girls;1278092;0;1110;The Land Girls;70;0
3288;8000000;Romance Comedy Drama Horror;Fido;5244518;426224;910;Fido;66;-7573776
3289;0;Comedy Drama Romance;The Wendell Baker Story;1265683;0;990;The Wendell Baker Story;52;0
3290;8000000;Action Comedy;Wild Target;1,08E+16;3453043;980;Wild Target;64;-4546957
3291;8000000;Crime Horror Thriller;Pathology;9,78E+15;0;950;Pathology;56;-8000000
3292;0;Drama;Wuthering Heights;4409263;0;1420;Wuthering Heights;69;0
3293;8000000;Action Crime Drama Mystery Thriller;10th & Wolf;3,94E+16;143451;1070;10th & Wolf;63;-7856549
3294;0;Comedy Crime Drama Romance;Dear Wendy;2597665;0;1050;Dear Wendy;56;0
3295;8000000;Drama;Aloft;6,50E+16;53086;1120;Aloft;51;-7946914
3296;8000000;Science Fiction Animation;アキラ;39338097;553171;1240;Akira;78;-7446829
3297;22000000;Drama Action Thriller Crime;The Death and Life of Bobby Z;12893219;413454;970;The Death and Life of Bobby Z;58;-21586546
3298;8000000;Drama;Maurice Richard;983484;2019009;1240;The Rocket: The Legend of Rocket Richard;61;-5980991
3299;0;Action Drama Thriller;Swelter;2214925;0;960;Swelter;46;0
3300;0;Comedy Romance;非常幸运;186453;0;1140;My Lucky Star;43;0
3301;0;Drama Comedy Romance;Imagine Me & You;9100352;2455831;930;Imagine Me & You;70;2455831
3302;8000000;Drama;Mr. Church;7828459;0;1040;Mr. Church;70;-8000000
3303;7800000;Thriller Crime;Swimming Pool;1,10E+16;22441323;1020;Swimming Pool;64;14641323
3304;0;Action Drama;Green Street Hooligans: Underground;50005;0;900;Green Street Hooligans: Underground;54;0
3305;0;Action Adventure Science Fiction;The Blood of Heroes;641678;882290;1000;The Blood of Heroes;59;882290
3306;8000000;Action Crime Thriller;Code of Honor;2101718;0;1060;Code of Honor;41;-8000000
3307;7500000;Comedy Drama;Driving Miss Daisy;19585801;145793296;990;Driving Miss Daisy;70;138293296
3308;0;Comedy Drama;Soul Food;4105363;0;1140;Soul Food;66;0
3309;7500000;Crime Action Comedy Thriller;紅番區;17318839;32392047;910;Rumble in the Bronx;65;24892047
3310;7700000;Drama War;Loin des hommes;3363973;0;1100;Far from Men;66;-7700000
3311;6500000;Comedy Drama;Thank You for Smoking;2901153;24793509;920;Thank You for Smoking;71;18293509
3312;10200000;Horror;Hostel: Part II;2,07E+16;35619521;930;Hostel: Part II;56;25419521
3313;7500000;Drama Romance;An Education;16990308;26096852;1000;An Education;68;18596852
3314;10284523;Comedy Drama Romance;Shopgirl;4820166;11588205;1040;Shopgirl;57;1303682
3315;7500000;Comedy Drama;The Hotel New Hampshire;2226412;0;1090;The Hotel New Hampshire;58;-7500000
3316;6500000;Action Crime Drama Thriller;Narc;8526635;12633747;1050;Narc;68;6133747
3317;7500000;Comedy;Men with Brooms;1369528;4245870;1020;Men with Brooms;45;-3254130
3318;0;Action Adventure Comedy Crime;Witless Protection;1,82E+16;0;970;Witless Protection;40;0
3319;7500000;Drama Romance;The Work and the Glory;571663;3347647;1100;The Work and the Glory;61;-4152353
3320;8000000;Comedy;Extract;14652342;10848783;920;Extract;57;2848783
3321;0;Drama Music;Masked and Anonymous;1,72E+16;0;1120;Masked and Anonymous;52;0
3322;0;Drama Thriller Crime Foreign;Betty Fisher et autres histoires;2,42E+16;0;1030;Betty Fisher and Other Stories;70;0
3323;7500000;Drama Romance Science Fiction Thriller;Code 46;8859657;0;920;Code 46;62;-7500000
3324;7500000;Comedy;Outside Bet;8,67E+15;0;1010;Outside Bet;58;-7500000
3325;8000000;Drama;Albert Nobbs;7802245;5634828;1130;Albert Nobbs;62;-2365172
3326;12500000;Drama Action Crime;Black November;1589693;0;950;Black November;64;-12500000
3327;0;Family Comedy Romance;Ta Ra Rum Pum;553752;0;1560;Ta Ra Rum Pum;60;0
3328;7300000;Animation Drama;Persepolis;24281951;0;950;Persepolis;77;-7300000
3329;0;Thriller Adventure Fantasy;The Hole;9983004;0;920;The Hole;56;0
3330;7500000;Drama Thriller;Die Welle;25281197;19000000;1070;The Wave;75;11500000
3331;7000000;Thriller Horror;The Neon Demon;38150787;1333124;1170;The Neon Demon;64;-5666876
3332;7300000;Thriller Crime Drama Action;Harry Brown;16829837;10329747;1030;Harry Brown;67;3029747
3333;0;Horror Thriller;The Omega Code;1288173;2400000;1000;The Omega Code;44;2400000
3334;7500000;Comedy Drama Romance;Juno;19782725;231411584;960;Juno;70;223911584
3335;7500000;Action;Pound of Flesh;4943588;0;1040;Pound of Flesh;55;-7500000
3336;7200000;Adventure Action Thriller;Diamonds Are Forever;34634181;116019547;1200;Diamonds Are Forever;63;108819547
3337;6000000;Drama Crime;The Godfather;143659698;245066411;1750;The Godfather;84;239066411
3338;4000000;Drama Music Romance;Flashdance;1,84E+16;92921203;950;Flashdance;61;88921203
3339;7500000;Comedy Drama Romance;(500) Days of Summer;45610993;60722734;950;(500) Days of Summer;72;53222734
3340;7000000;Drama Romance;The Piano;17681707;116700000;1210;The Piano;71;109700000
3341;7000000;Drama Comedy;Magic Mike;35897151;167221571;1100;Magic Mike;61;160221571
3342;0;Thriller Horror;Darkness Falls;11199544;0;860;Darkness Falls;49;0
3343;7000000;Adventure Action Thriller;Live and Let Die;30465138;161777836;1210;Live and Let Die;64;154777836
3344;7000000;Comedy Drama Family;My Dog Skip;5675535;0;950;My Dog Skip;65;-7000000
3345;0;Comedy Romance;Definitely, Maybe;2,92E+16;55447968;1120;Definitely, Maybe;67;55447968
3346;6600000;Comedy;Jumping the Broom;4,49E+16;37710610;1120;Jumping the Broom;60;31110610
3347;7000000;Drama History;Good Night, and Good Luck.;17717681;54600000;930;Good Night, and Good Luck.;68;47600000
3348;7000000;Crime Drama;Capote;17434862;49084830;1140;Capote;68;42084830
3349;7000000;Thriller Action Crime;Desperado;2,55E+16;25405445;1040;Desperado;68;18405445
3350;9000000;Adventure Action Romance Science Fiction;Logan's Run;1,23E+16;25000000;1190;Logan's Run;66;16000000
3351;7000000;Adventure Action Thriller;The Man with the Golden Gun;3,02E+16;97572000;1250;The Man with the Golden Gun;63;90572000
3352;7000000;Action Adventure Comedy Crime Drama;Action Jackson;6,87E+16;20256975;960;Action Jackson;49;13256975
3353;0;Adventure Horror;The Descent;23413188;0;990;The Descent;68;0
3354;0;Documentary;Michael Jordan to the Max;1,83E+16;21268532;460;Michael Jordan to the Max;75;21268532
3355;7000000;Horror;Devil's Due;1,47E+16;36433975;890;Devil's Due;44;29433975
3356;7000000;Comedy Romance;Flirting with Disaster;5500324;14702438;920;Flirting with Disaster;63;7702438
3357;0;Drama Horror Crime;The Devil's Rejects;16754452;0;1070;The Devil's Rejects;66;0
3358;700000;Crime Drama Comedy;Dope;29761163;17986781;1030;Dope;72;17286781
3359;7000000;Drama Action Thriller Crime;In Too Deep;2772178;14011454;970;In Too Deep;62;7011454
3360;7000000;Horror;House of 1000 Corpses;1,93E+16;16829545;890;House of 1000 Corpses;60;9829545
3361;0;Horror Action Thriller Science Fiction;Alien Zone;3,72E+16;0;900;Alien Zone;40;0
3362;7000000;Comedy Drama;A Serious Man;23612409;31430334;1050;A Serious Man;66;24430334
3363;7500000;Comedy Drama Mystery;Get Low;6557643;0;1030;Get Low;65;-7500000
3364;7000000;Adventure Comedy Fantasy Horror;Warlock;;;;;;-7000000
;; and Kassandra (Lori Singer);01/06/1989;1030;;58;Steve Miner;;0
3365;7000000;Romance Drama;Beyond the Lights;8079046;14618727;1160;Beyond the Lights;70;7618727
3366;7000000;Drama Romance;A Single Man;21626288;0;1010;A Single Man;73;-7000000
3367;7000000;Drama;The Last Temptation of Christ;1,47E+16;8373585;1640;The Last Temptation of Christ;70;1373585
3368;7000000;Romance Comedy Drama;Outside Providence;2627232;7292175;960;Outside Providence;56;292175
3369;7000000;Drama Comedy Music Romance;Bride & Prejudice;12150871;0;1110;Bride & Prejudice;65;-7000000
3370;0;Adventure Drama Action History;Rabbit-Proof Fence;2128211;0;940;Rabbit-Proof Fence;68;0
3371;0;Comedy;Who's Your Caddy?;2881239;0;930;Who's Your Caddy?;38;0
3372;7;Thriller Action Horror Science Fiction Crime;Split Second;4857028;5;900;Split Second;57;-2
3373;7000000;Action Adventure Drama Family;The Other Side of Heaven;2206097;4720371;1130;The Other Side of Heaven;67;-2279629
3374;7000000;Drama Romance;Veer-Zaara;3721858;29385320;1920;Veer-Zaara;74;22385320
3375;7000000;Drama;Redbelt;5091253;0;990;Redbelt;64;-7000000
3376;7000000;Comedy Drama Romance;Cyrus;15212569;0;910;Cyrus;61;-7000000
3377;0;Drama Family;A Dog Of Flanders;838938;0;960;A Dog Of Flanders;64;0
3378;7000000;Drama Crime;Auto Focus;7,05E+15;2062066;1040;Auto Focus;61;-4937934
3379;7000000;Drama;Factory Girl;11400229;0;900;Factory Girl;62;-7000000
3380;7000000;Drama Thriller;We Need to Talk About Kevin;21276864;6038942;1120;We Need to Talk About Kevin;74;-961058
3381;0;Drama Family;The Christmas Candle;1799504;0;1000;The Christmas Candle;58;0
3382;7000000;Action Drama;The Mighty Macs;2932784;0;1020;The Mighty Macs;50;-7000000
3383;7000000;Comedy;Losin' It;2550045;1246141;1000;Losin' It;45;-5753859
3384;7000000;Drama Romance;Mother and Child;5517597;0;1250;Mother and Child;67;-7000000
3385;0;Action Adventure Drama War;March or Die;3829937;0;1070;March or Die;62;0
3386;0;Fantasy Comedy Science Fiction;Les visiteurs;8893676;0;1070;The Visitors;71;0
3387;8000000;Comedy Drama;Somewhere;9590373;0;980;Somewhere;60;-8000000
3388;7000000;Comedy Drama;I Hope They Serve Beer in Hell;7155519;1429299;1060;I Hope They Serve Beer in Hell;57;-5570701
3389;0;Comedy;Chairman of the Board;587276;0;950;Chairman of the Board;27;0
3390;7000000;Drama;Hesher;13635828;382946;1060;Hesher;67;-6617054
3391;0;Comedy Crime Drama;Dom Hemingway;10416332;523511;930;Dom Hemingway;58;523511
3392;3500000;Mystery Drama Adventure;Gerry;5038953;0;1030;Gerry;62;-3500000
3393;7000000;Drama Romance;The Heart of Me;1498245;0;960;The Heart of Me;77;-7000000
3394;7000000;Romance Drama;Freeheld;8184588;573335;1030;Freeheld;71;-6426665
3395;7000000;Comedy;The Extra Man;226778;453079;1080;The Extra Man;59;-6546921
3396;7000000;Drama Science Fiction;Трудно быть богом;3120016;1310673;1700;Hard to Be a God;67;-5689327
3397;7000000;Crime Thriller Comedy;Ca$h;8207425;46488;1080;Ca$h;60;-6953512
3398;0;Drama;Wah-Wah;2356244;0;1200;Wah-Wah;63;0
3399;6000000;Action Thriller Crime;The Boondock Saints;3,49E+16;30471;1080;The Boondock Saints;72;-5969529
3400;0;Crime Thriller;Z 風暴;542814;0;920;Z Storm;58;0
3401;7000000;Horror Thriller;Twixt;5060656;0;840;Twixt;50;-7000000
3402;7000000;Animation Fantasy;Снежная королева;533861;12400000;760;The Snow Queen;51;5400000
3403;0;Family Animation Comedy Adventure;Alpha and Omega: The Legend of the Saw Tooth Cave;1874783;0;530;Alpha and Omega: The Legend of the Saw Tooth Cave;65;0
3404;0;Romance Western;Pale Rider;1,46E+16;41410568;1150;Pale Rider;70;41410568
3405;7000000;Adventure Science Fiction;Stargate: The Ark of Truth;8591387;8900000;970;Stargate: The Ark of Truth;69;1900000
3406;6900000;Comedy Drama;Dazed and Confused;26181753;7993039;1020;Dazed and Confused;74;1093039
3407;0;Comedy Drama Family Music;High School Musical 2;2101755;7000000;1040;High School Musical 2;61;7000000
3408;0;Drama Romance;Two Lovers and a Bear;3139294;0;960;Two Lovers and a Bear;68;0
3409;7000000;Thriller Crime Drama;Criminal Activities;6665164;0;940;Criminal Activities;58;-7000000
3410;0;Drama History Romance;Aimee & Jaguar;2,83E+16;0;1250;Aimee & Jaguar;63;0
3411;0;Comedy Drama;The Chumscrubber;3528643;0;1080;The Chumscrubber;67;0
3412;6800000;Action Thriller Crime;Shade;4665309;0;1010;Shade;61;-6800000
3413;6900000;Horror Thriller;House at the End of the Street;25613197;44287131;1010;House at the End of the Street;56;37387131
3414;6800000;Drama War Mystery;Incendies;21285206;7103838;1300;Incendies;79;303838
3415;0;Drama Comedy Romance;Ricordati di me;4240495;0;1250;Remember Me, My Love;58;0
3416;0;Action Comedy Crime Drama;Perrier’s Bounty;3810943;0;880;Perrier’s Bounty;51;0
3417;4000000;Drama Action Crime;Tropa de Elite;23604936;0;1150;Elite Squad;78;-4000000
3418;6500000;Horror;Annabelle;6,02E+16;255273813;990;Annabelle;56;248773813
3419;7;Comedy Drama Foreign Romance;Bran Nue Dae;50456;7;820;Bran Nue Dae;52;0
3420;6500000;Crime Drama;Boyz n the Hood;17705671;57504069;1120;Boyz n the Hood;74;51004069
3421;6500000;Drama Music;La Bamba;6,85E+15;54215416;1080;La Bamba;68;47715416
3422;0;Comedy Drama Romance;The Four Seasons;8067702;0;1070;The Four Seasons;63;0
3423;6500000;Horror Mystery Thriller;Dressed to Kill;11208769;31899000;1050;Dressed to Kill;68;25399000
3424;6500000;Action Adventure Drama Family;The Adventures of Huck Finn;2,16E+16;0;1080;The Adventures of Huck Finn;62;-6500000
3425;6500000;Crime Comedy Thriller;Go;11142389;28451622;980;Go;70;21951622
3426;6500000;Comedy Drama Romance;Friends with Money;1,19E+16;13368437;880;Friends with Money;51;6868437
3427;6500000;Science Fiction Thriller;The Andromeda Strain;12524953;12376563;1310;The Andromeda Strain;70;5876563
3428;0;Horror Thriller;Bats;1537859;10;910;Bats;41;10
3429;0;Drama;Nirgendwo in Afrika;3,48E+16;0;1400;Nowhere in Africa;70;0
3430;6500000;Drama;Shame;40688426;17693675;1000;Shame;70;11193675
3431;6500000;Drama Thriller Crime;Layer Cake;240034;11850214;1050;Layer Cake;70;5350214
3432;6500000;Drama;The Work and the Glory II: American Zion;2639106;2025032;1000;The Work and the Glory II: American Zion;80;-4474968
3433;6500000;Drama Thriller;The East;16574756;2401510;1160;The East;65;-4098490
3434;6500000;Romance Drama;A Home at the End of the World;5483531;1548955;960;A Home at the End of the World;68;-4951045
3435;0;Drama Comedy Foreign;Aberdeen;1068819;0;1130;Aberdeen;70;0
3436;6500000;Drama History;The Messenger;8,43E+15;1521261;1130;The Messenger;71;-4978739
3437;6500000;Action Drama Thriller Adventure;Tracker;2074295;0;1020;Tracker;60;-6500000
3438;0;Drama;Control;11357474;8159508;1210;Control;75;8159508
3439;6400000;Action Thriller Science Fiction;The Terminator;7,42E+15;78371200;1080;The Terminator;73;71971200
3440;4800000;Comedy Drama Romance;Good bye, Lenin!;11086001;79384880;1210;Good bye, Lenin!;74;74584880
3441;10000000;Drama;The Damned United;13409125;0;970;The Damned United;72;-10000000
3442;4000000;Comedy Horror;The Return of the Living Dead;14961629;14237000;910;The Return of the Living Dead;73;10237000
3443;6000000;Romance Comedy;Mallrats;16139771;2122561;940;Mallrats;68;-3877439
3444;6000000;Romance;Grease;67608041;181813770;1100;Grease;72;175813770
3445;6000000;Drama War Action;Platoon;49802914;138530565;1200;Platoon;75;132530565
3446;6000000;Documentary;Fahrenheit 9/11;1620985;119114517;1220;Fahrenheit 9/11;68;113114517
3447;6000000;History Drama Western Crime;Butch Cassidy and the Sundance Kid;24499996;102308889;1100;Butch Cassidy and the Sundance Kid;74;96308889
3448;6000000;Comedy Family Fantasy;Mary Poppins;59961523;102272727;1390;Mary Poppins;74;96272727
3449;6000000;Drama;Ordinary People;12541983;0;1240;Ordinary People;74;-6000000
3450;6000000;Crime Drama Music;West Side Story;23431117;43656822;1520;West Side Story;70;37656822
3451;6000000;Comedy;Caddyshack;15929648;39846344;980;Caddyshack;66;33846344
3452;0;Comedy Drama Romance;The Brothers;3029944;0;1060;The Brothers;65;0
3453;6000000;Comedy Drama Romance;The Wood;5537646;25059640;1060;The Wood;71;19059640
3454;6000000;Drama Crime Thriller;The Usual Suspects;6,40E+15;23341568;1060;The Usual Suspects;81;17341568
3455;8000000;Horror Thriller;A Nightmare on Elm Street 5: The Dream Child;1,27E+16;22168359;890;A Nightmare on Elm Street 5: The Dream Child;55;14168359
3456;5000000;Comedy Romance;National Lampoon’s Van Wilder;35108498;38275483;920;National Lampoon’s Van Wilder;59;33275483
3457;6000000;Drama Romance;The Wrestler;40196514;44703995;1090;The Wrestler;73;38703995
3458;6000000;Western;Duel in the Sun;760445;20400000;1440;Duel in the Sun;62;14400000
3459;0;Comedy;Best in Show;10982255;0;900;Best in Show;67;0
3460;6000000;Science Fiction Action;Escape from New York;24351305;50244700;990;Escape from New York;69;44244700
3461;0;Comedy Drama;School Daze;3159574;0;1210;School Daze;62;0
3462;6000000;Comedy Family;Daddy Day Camp;12601677;18197398;890;Daddy Day Camp;44;12197398
3463;12716953;Crime Action Comedy;一個好人;7077505;18814720;1130;Mr. Nice Guy;63;6097767
3464;6000000;Comedy Music;A Mighty Wind;4053017;18750246;910;A Mighty Wind;66;12750246
3465;0;Comedy Drama Romance;Mystic Pizza;6379933;0;1040;Mystic Pizza;59;0
3466;6000000;Comedy Drama Fantasy Romance;Sliding Doors;15639016;58000000;990;Sliding Doors;65;52000000
3467;6000000;Crime Horror Thriller;Tales from the Hood;389204;12000000;980;Tales from the Hood;54;6000000
3468;6000000;Drama;The Last King of Scotland;2,63E+16;48027970;1210;The Last King of Scotland;74;42027970
3469;5000000;Horror Thriller;Halloween 5: The Revenge of Michael Myers;8008844;11642254;960;Halloween 5: The Revenge of Michael Myers;52;6642254
3470;5000000;Comedy Crime Drama;Bernie;1,27E+16;9206470;1000;Bernie;65;4206470
3471;6000000;Documentary;Dolphins and Whales: Tribes of the Ocean;41651;7518876;420;Dolphins and Whales: Tribes of the Ocean;80;1518876
3472;0;Drama Romance;Pollock;8483531;0;1220;Pollock;66;0
3473;6000000;Comedy Drama Romance;200 Cigarettes;3,56E+16;6852450;1010;200 Cigarettes;61;852450
3474;6000000;Drama Thriller;The Words;1,50E+16;13231461;960;The Words;64;7231461
3475;0;Comedy Western;Casa De Mi Padre;5754416;0;840;Casa De Mi Padre;55;0
3476;6000000;Drama Comedy;City Island;6497285;6670712;1040;City Island;69;670712
3477;6000000;Action Comedy Thriller Crime;The Guard;19411141;19560274;960;The Guard;68;13560274
3478;7000000;Comedy;College;7,03E+15;6230276;940;College;48;-769724
3479;6000000;Drama Romance;The Virgin Suicides;26218912;10409377;970;The Virgin Suicides;71;4409377
3480;0;Comedy Drama;Little Voice;4647547;0;970;Little Voice;66;0
3481;0;Comedy Romance;Miss March;9371534;0;890;Miss March;54;0
3482;5500000;Drama Comedy;Wish I Was Here;1,50E+16;5483299;1200;Wish I Was Here;64;-16701
3483;6000000;Comedy;Simply Irresistible;5696491;4398989;950;Simply Irresistible;55;-1601011
3484;0;Comedy Music;Hedwig and the Angry Inch;425422;0;950;Hedwig and the Angry Inch;74;0
3485;6000000;Action;Only the Strong;5411243;3283371;990;Only the Strong;69;-2716629
3486;0;Mystery Drama Thriller Horror;Goddess of Love;1273773;0;960;Goddess of Love;62;0
3487;6000000;Drama History;Shattered Glass;627257;2944752;940;Shattered Glass;66;-3055248
3488;6000000;Comedy Crime Thriller;Novocaine;4,15E+16;2025238;950;Novocaine;60;-3974762
3489;0;Drama Thriller;The Business of Strangers;1369649;0;840;The Business of Strangers;57;0
3490;6244087;Adventure Western;The Wild Bunch;1,50E+16;638641;1450;The Wild Bunch;76;-5605446
3491;6000000;Drama;The Wackness;7161051;2899975;990;The Wackness;62;-3100025
3492;6000000;Thriller Adventure Drama Crime;The First Great Train Robbery;1,24E+16;0;1100;The First Great Train Robbery;66;-6000000
3493;0;Drama;Morvern Callar;2,51E+16;0;970;Morvern Callar;72;0
3494;6000000;Action Adventure Fantasy Science Fiction;Beastmaster 2: Through the Portal of Time;1478505;869325;1070;Beastmaster 2: Through the Portal of Time;46;-5130675
3495;6000000;Drama;The 5th Quarter;215464;399611;970;The 5th Quarter;47;-5600389
3496;0;Drama;La fleur du mal;1229667;0;1040;The Flower of Evil;57;0
3497;6000000;Drama;The Greatest;6903186;0;990;The Greatest;62;-6000000
3498;134005;Drama History;Snow Flower and the Secret Fan;2,26E+16;1332231;1040;Snow Flower and the Secret Fan;53;1198226
3499;6000000;Drama Romance;Come Early Morning;3427061;0;970;Come Early Morning;59;-6000000
3500;0;Action Comedy;Lucky Break;669169;0;1070;Lucky Break;65;0
3501;0;Drama;Julia;6077735;0;1170;Julia;63;0
3502;6000000;Comedy;Surfer, Dude;2404626;69497;850;Surfer, Dude;47;-5930503
3503;0;Documentary;Lake of Fire;4,76E+16;25;1520;Lake of Fire;80;25
3504;6000000;Crime Drama Thriller;11:14;1,50E+16;0;860;11:14;68;-6000000
3505;0;Action Thriller;Men of War;1734764;0;1030;Men of War;54;0
3506;0;Crime Mystery Thriller;Don McKay;1,50E+16;0;870;Don McKay;54;0
3507;12000000;Crime Drama Thriller;Deadfall;1019041;66351;950;Deadfall;56;-11933649
3508;6000000;Drama Family;A Shine of Rainbows;12099486;0;1010;A Shine of Rainbows;63;-6000000
3509;6000000;Action Thriller;The Hit List;4957014;0;900;The Hit List;52;-6000000
3510;0;Romance Comedy Drama;Emma;2,14E+16;0;2400;Emma;76;0
3511;5952000;Horror Mystery Science Fiction;Videodrome;18119265;2120439;870;Videodrome;71;-3831561
3512;5300000;Drama Comedy Romance;L'Auberge espagnole;13034602;3897799;1220;The Spanish Apartment;70;-1402201
3513;6000000;Drama;Song One;6,35E+16;32251;860;Song One;55;-5967749
3514;4000000;Drama History War;Oorlogswinter;5013575;530048;1030;Winter in Wartime;68;-3469952
3515;0;Comedy;Freaky Deaky;4448353;0;900;Freaky Deaky;49;0
3516;5800000;Action Drama Thriller War;The Train;449029;6800000;1330;The Train;72;1000000
3517;0;Drama Thriller;Trade Of Innocents;2204138;0;910;Trade Of Innocents;55;0
3518;6000000;Action Crime Drama Thriller;ต้มยำกุ้ง;1181832;27165581;1080;The Protector;68;21165581
3519;0;Comedy;Stiff Upper Lips;356495;0;990;Stiff Upper Lips;100;0
3520;3500159;Comedy Drama Romance;Bend It Like Beckham;22054546;76578641;1120;Bend It Like Beckham;62;73078482
3521;0;Drama;Sunshine State;4245123;0;1410;Sunshine State;60;0
3522;5800000;Action Adventure Drama;Crossover;3201886;7000000;950;Crossover;42;1200000
3523;0;Action Comedy;Khiladi 786;1,14E+16;126;1390;Khiladi 786;47;126
3524;5600000;Thriller Horror;[REC]²;22341462;18469680;850;[REC]²;64;12869680
3525;0;Comedy Music Family;Standing Ovation;3,06E+16;531826;1050;Standing Ovation;39;531826
3526;5500000;Comedy Crime Drama;The Sting;28500913;159616327;1290;The Sting;79;154116327
3527;5500000;Drama History;Chariots of Fire;10439971;58972904;1230;Chariots of Fire;68;53472904
3528;0;Comedy Drama Romance;Diary of a Mad Black Woman;3784535;0;1160;Diary of a Mad Black Woman;64;0
3529;0;Drama;Shine;10396305;0;1050;Shine;73;0
3530;6000000;Romance Comedy Drama;Don Jon;33296684;0;900;Don Jon;59;-6000000
3531;5500000;Western;High Plains Drifter;1,91E+16;15700000;1050;High Plains Drifter;74;10200000
3532;7000000;Comedy Drama;Ghost World;14072941;0;1110;Ghost World;71;-7000000
3533;0;Drama Romance;Iris;2714043;0;910;Iris;62;0
3534;5500000;Comedy Science Fiction;Galaxina;2141143;4865000;950;Galaxina;33;-635000
3535;0;Drama;Les Choristes;2,10E+16;0;960;The Chorus;75;0
3536;4361898;Comedy Romance;Mambo Italiano;2080741;3031801;920;Mambo Italiano;56;-1330097
3537;5000000;Crime Drama Mystery Thriller;Wonderland;779068;2466444;1040;Wonderland;62;-2533556
3538;6500000;Drama;Do the Right Thing;15580335;37295445;1200;Do the Right Thing;76;30795445
3539;0;Drama;Harvard Man;5336243;0;990;Harvard Man;48;0
3540;3850000;Drama Comedy;Le Havre;10787322;0;930;Le Havre;68;-3850000
3541;0;Drama Thriller Crime Mystery;Irréversible;32476098;792;970;Irreversible;71;792
3542;5500000;Comedy Drama;R100;321392;0;1000;R100;54;-5500000
3543;2200000;Drama;Rang De Basanti;5206967;11502151;1570;Rang De Basanti;72;9302151
3544;0;Drama;Animals;15846;0;900;Animals;62;0
3545;8000000;Comedy Thriller Action Drama;Salvation Boulevard;3,65E+15;0;960;Salvation Boulevard;56;-8000000
3546;0;Comedy;The Ten;3865122;0;960;The Ten;49;0
3547;0;Drama Comedy Foreign;A Room for Romeo Brass;1391958;0;900;A Room for Romeo Brass;73;0
3548;0;Thriller Crime;Hodejegerne;20821846;15699707;1000;Headhunters;71;15699707
3549;0;Science Fiction Comedy Thriller Horror;Grabbers;9451228;0;940;Grabbers;60;0
3550;0;Comedy Drama;Saint Ralph;;;;;;0
;; who is secretly living on his own while his widowed; i.e.;;1688495;;95.0;;1688495
3551;5500000;Drama;Miss Julie;5,03E+16;5000000;1200;Miss Julie;59;-500000
3552;5100000;Science Fiction Drama Fantasy Romance;Somewhere in Time;5,93E+16;0;1030;Somewhere in Time;72;-5100000
3553;0;Drama Action Crime Foreign;Dum Maaro Dum;75817;0;1300;Dum Maaro Dum;54;0
3554;5000000;Horror Thriller;Insidious: Chapter 2;48375848;0;1060;Insidious: Chapter 2;65;-5000000
3555;4000000;Horror;Saw II;4,22E+16;152925093;920;Saw II;63;148925093
3556;15000000;Thriller Science Fiction Drama;10 Cloverfield Lane;5,37E+16;108286421;1030;10 Cloverfield Lane;68;93286421
3557;5000000;Documentary Comedy;Jackass: The Movie;14752587;64282312;870;Jackass: The Movie;61;59282312
3558;4900000;Horror Thriller;Lights Out;48170508;44107032;810;Lights Out;63;39207032
3559;5000000;Horror;Paranormal Activity 3;2915813;205703818;830;Paranormal Activity 3;59;200703818
3560;5000000;Horror;Ouija;5630466;103590271;890;Ouija;49;98590271
3561;5000000;Horror Thriller;A Nightmare on Elm Street 3: Dream Warriors;1,73E+16;44793222;960;A Nightmare on Elm Street 3: Dream Warriors;65;39793222
3562;5500000;Comedy Drama;No se Aceptan Devoluciones;959729;99067206;1150;Instructions Not Included;75;93567206
3563;5000000;Horror;Paranormal Activity 4;20326337;142817992;950;Paranormal Activity 4;52;137817992
3564;4100000;Drama;The Robe;4028875;36000000;1350;The Robe;64;31900000
3565;5000000;Comedy;The Return of the Pink Panther;6470766;41833347;1130;The Return of the Pink Panther;67;36833347
3566;11000000;Horror Thriller Comedy;Freddy's Dead: The Final Nightmare;16856231;34872033;890;Freddy's Dead: The Final Nightmare;51;23872033
3567;8000000;Crime Drama;Monster;19683187;60378584;1100;Monster;70;52378584
3568;5000000;Adventure Drama Science Fiction;20,000 Leagues Under the Sea;9358197;28200000;1270;20,000 Leagues Under the Sea;68;23200000
3569;5000000;Horror Thriller;Paranormal Activity: The Marked Ones;19984477;86362372;840;Paranormal Activity: The Marked Ones;52;81362372
3570;5000000;Drama History;The Elephant Man;3,03E+16;26010864;1240;The Elephant Man;79;21010864
3571;5000000;Drama History;Dallas Buyers Club;59454473;55198285;1170;Dallas Buyers Club;79;50198285
3572;3300000;Thriller Horror;The Lazarus Effect;2,03E+16;64110728;830;The Lazarus Effect;51;60810728
3573;9000000;Mystery Thriller;Memento;60715151;39723096;1130;Memento;81;30723096
3574;5000000;Horror;Oculus;35871248;44030246;1040;Oculus;63;39030246
3575;5000000;Comedy;Clerks II;18077963;26888376;970;Clerks II;69;21888376
3576;5000000;Drama Comedy Music;Billy Elliot;20428237;110000000;1100;Billy Elliot;74;105000000
3577;4600000;Comedy Drama;The Way Way Back;3214444;23198652;1030;The Way Way Back;71;18598652
3578;0;Comedy;House Party 2;3,67E+15;0;940;House Party 2;47;0
3579;3500000;Family Drama Action Western Romance;The Man from Snowy River;3,66E+16;20659423;1040;The Man from Snowy River;68;17159423
3580;0;Animation Family Comedy;Doug's 1st Movie;188484;0;770;Doug's 1st Movie;54;0
3581;5000000;Drama;The Apostle;4227807;0;1340;The Apostle;61;-5000000
3582;0;Drama;Mommie Dearest;3102862;0;1290;Mommie Dearest;65;0
3583;10000000;Comedy Drama;Our Idiot Brother;15688439;17273593;900;Our Idiot Brother;59;7273593
3584;5000000;Action Drama;Race;229951;24804129;1340;Race;71;19804129
3585;0;Drama;The Players Club;5,77E+16;0;1040;The Players Club;64;0
3586;5000000;Horror Thriller;As Above, So Below;2,65E+16;40100000;930;As Above, So Below;61;35100000
3587;0;Drama Thriller;Addicted;7544515;0;1050;Addicted;54;0
3588;0;Drama;Eve's Bayou;1126941;0;1090;Eve's Bayou;61;0
3589;5000000;Drama;Still Alice;35307577;43884652;990;Still Alice;75;38884652
3590;5000000;History Drama;The Egyptian;4079111;15000000;1390;The Egyptian;60;10000000
3591;5000000;Action Crime Thriller;Nighthawks;7,06E+16;19905359;990;Nighthawks;64;14905359
3592;5000000;Horror Thriller;Friday the 13th Part VIII: Jason Takes Manhattan;12904615;14000000;1000;Friday the 13th Part VIII: Jason Takes Manhattan;48;9000000
3593;5000000;Comedy Drama Romance;My Big Fat Greek Wedding;18115566;368744044;950;My Big Fat Greek Wedding;62;363744044
3594;5000000;Drama Crime;Spring Breakers;62554173;31724284;940;Spring Breakers;50;26724284
3595;5000000;Horror Thriller;Halloween: The Curse of Michael Myers;9483717;15116634;880;Halloween: The Curse of Michael Myers;50;10116634
3596;5000000;Drama Romance;Y tu mamá también;1,69E+16;33616692;1060;Y Tu Mamá También;73;28616692
3597;4000000;Horror Comedy;Shaun of the Dead;4912486;30039392;990;Shaun of the Dead;75;26039392
3598;0;Drama Horror;The Haunting of Molly Hartley;8309894;0;820;The Haunting of Molly Hartley;43;0
3599;5000000;Drama Mystery Romance;Lone Star;5,96E+16;13269963;1350;Lone Star;69;8269963
3600;5000000;Horror Thriller;Halloween 4: The Return of Michael Myers;9,30E+15;17768757;880;Halloween 4: The Return of Michael Myers;59;12768757
3601;5000000;Horror Mystery;April Fool's Day;8,19E+15;0;890;April Fool's Day;58;-5000000
3602;0;Comedy Drama;Diner;587193;0;1100;Diner;69;0
3603;5000000;Action Crime Drama Romance Thriller;Lone Wolf McQuade;8452666;12232628;1070;Lone Wolf McQuade;55;7232628
3604;5000000;Horror Thriller Science Fiction;Apollo 18;17028252;25562924;860;Apollo 18;50;20562924
3605;5000000;Comedy Drama;Sunshine Cleaning;1,93E+16;16174377;1020;Sunshine Cleaning;65;11174377
3606;5000000;Action Thriller;No Escape;38006982;54418872;1030;No Escape;67;49418872
3607;0;Action Fantasy;The Beastmaster;6377523;14056528;1180;The Beastmaster;60;14056528
3608;5000000;Drama History Romance War;Solomon and Sheba;835617;12200000;1390;Solomon and Sheba;54;7200000
3609;20000000;Romance Comedy;Fifty Shades of Black;14947588;21164799;920;Fifty Shades of Black;43;1164799
3610;0;Drama Romance;Not Easily Broken;51299;0;990;Not Easily Broken;63;0
3611;4;Drama Romance War;A Farewell to Arms;1199451;25;890;A Farewell to Arms;62;21
3612;0;Comedy Romance;The Perfect Match;3,81E+16;0;960;The Perfect Match;52;0
3613;5500000;Fantasy Animation Science Fiction Family;Digimon: The Movie;37387;0;820;Digimon: The Movie;62;-5500000
3614;0;Comedy Drama;Saved!;9,85E+15;0;920;Saved!;63;0
3615;8000000;Comedy Crime Drama;Les Invasions barbares;303091;3432342;990;The Barbarian Invasions;67;-4567658
3616;0;Action Adventure Drama Romance;Robin and Marian;3199904;0;1060;Robin and Marian;66;0
3617;5000000;Action Adventure Horror Thriller;The Forsaken;2739307;0;900;The Forsaken;49;-5000000
3618;5000000;Action Adventure War Thriller;Force 10 from Navarone;5348446;7230000;1180;Force 10 from Navarone;64;2230000
3619;5000000;Comedy;UHF;4070044;0;970;UHF;67;-5000000
3620;0;Comedy;Grandma's Boy;9974681;6538177;940;Grandma's Boy;66;6538177
3621;5000000;Comedy Drama;Slums of Beverly Hills;6,31E+16;0;910;Slums of Beverly Hills;65;-5000000
3622;5000000;Western;C'era una volta il West;49333137;5321508;1750;Once Upon a Time in the West;81;321508
3623;5000000;Action Comedy Thriller;Made;4149628;5476060;940;Made;63;476060
3624;5000000;Science Fiction Drama;Moon;46114184;9760104;970;Moon;76;4760104
3625;0;Comedy;Keeping Up with the Steins;3562563;0;900;Keeping Up with the Steins;52;0
3626;5000000;Documentary;Sea Rex 3D: Journey to a Prehistoric World;4498368;4074023;410;Sea Rex 3D: Journey to a Prehistoric World;59;-925977
3627;5000000;Drama;The Sweet Hereafter;7,67E+16;3263585;1120;The Sweet Hereafter;68;-1736415
3628;4000000;Drama History;Des hommes et des dieux;4992475;41424067;1200;Of Gods and Men;65;37424067
3629;5000000;Comedy Drama;Bottle Shock;6174435;4040588;1100;Bottle Shock;66;-959412
3630;0;Comedy Horror Science Fiction;Jekyll and Hyde ... Together Again;805312;0;870;Jekyll and Hyde ... Together Again;46;0
3631;5000000;Drama Fantasy;Heavenly Creatures;8753409;3049135;990;Heavenly Creatures;70;-1950865
3632;5000000;Drama;90 Minutes in Heaven;3,94E+16;4842699;1210;90 Minutes in Heaven;54;-157301
3633;5000000;Comedy Drama Romance;Everything Must Go;9169411;2614773;970;Everything Must Go;60;-2385227
3634;5000000;Comedy Crime Mystery Thriller;Zero Effect;2732031;1980338;1160;Zero Effect;60;-3019662
3635;5000000;Thriller Drama;The Machinist;35252056;8203235;1010;The Machinist;73;3203235
3636;5000000;Drama Crime;Light Sleeper;6063868;0;1030;Light Sleeper;57;-5000000
3637;5000000;Thriller Crime Drama Mystery;Kill the Messenger;21343093;2450846;1120;Kill the Messenger;66;-2549154
3638;5000000;Drama;Rabbit Hole;10095184;5129058;910;Rabbit Hole;69;129058
3639;5000000;Comedy Drama Crime;Party Monster;4129165;742898;980;Party Monster;59;-4257102
3640;5000000;Horror Crime Thriller;Green Room;3,00E+16;3220371;950;Green Room;67;-1779629
3641;5000000;Comedy Drama Romance;The Oh in Ohio;6759235;0;880;The Oh in Ohio;58;-5000000
3642;5000000;Drama Science Fiction Mystery;Atlas Shrugged Part III: Who is John Galt?;1,73E+16;846704;990;Atlas Shrugged Part III: Who is John Galt?;39;-4153296
3643;7000000;Comedy Crime Drama;Bottle Rocket;11700578;560069;910;Bottle Rocket;68;-6439931
3644;6000000;Crime Drama Thriller;Albino Alligator;2,39E+16;0;970;Albino Alligator;56;-6000000
3645;0;Drama Foreign History;Gandhi, My Father;80704;0;1360;Gandhi, My Father;60;0
3646;0;Documentary;Standard Operating Procedure;888986;0;1170;Standard Operating Procedure;66;0
3647;0;Drama;Out of the Blue;679351;0;940;Out of the Blue;65;0
3648;5000000;Comedy Horror;Tucker and Dale vs Evil;19940245;5476793;890;Tucker and Dale vs Evil;73;476793
3649;0;Drama Romance;Lovely, Still;1286991;0;920;Lovely, Still;62;0
3650;0;Action Drama Romance;Tycoon;42442;0;1280;Tycoon;66;0
3651;0;Comedy Drama;Desert Blue;1116206;0;900;Desert Blue;55;0
3652;5000000;Horror Science Fiction Thriller;Decoys;3,05E+16;0;950;Decoys;47;-5000000
3653;5000000;Horror Thriller;The Visit;3894708;98450062;940;The Visit;60;93450062
3654;5000000;Drama War;Redacted;3792015;782102;900;Redacted;62;-4217898
3655;0;Romance Thriller;Fascination;2,20E+16;0;950;Fascination;38;0
3656;5000000;Horror Thriller Science Fiction;Area 51;7794;0;910;Area 51;42;-5000000
3657;5000000;Thriller;Mientras duermes;9136965;0;1070;Sleep Tight;70;-5000000
3658;0;Horror Comedy Crime Thriller;The Cottage;839685;0;920;The Cottage;63;0
3659;0;Drama Fantasy Comedy;Dead Like Me: Life After Death;7864905;0;870;Dead Like Me: Life After Death;58;0
3660;0;Comedy Documentary;Farce of the Penguins;1,96E+16;0;800;Farce of the Penguins;32;0
3661;0;Drama;Flying By;1,55E+16;0;950;Flying By;70;0
3662;5000000;Music Drama Comedy;Rudderless;10619574;0;1050;Rudderless;74;-5000000
3663;5000000;Family Animation;Henry & Me;999655;0;670;Henry & Me;30;-5000000
3664;0;Romance Comedy;Christmas Eve;1985243;0;950;Christmas Eve;61;0
3665;0;TV Movie Crime Drama Thriller;We Have Your Husband;102003;0;890;We Have Your Husband;50;0
3666;15000000;Thriller Drama;Dying of the Light;1,05E+16;0;940;Dying of the Light;45;-15000000
3667;0;Action Thriller War;Born Of War;1136568;0;1090;Born Of War;41;0
3668;5000000;Drama Action Thriller Science Fiction;Capricorn One;11095219;0;1230;Capricorn One;64;-5000000
3669;0;Comedy Drama;Should've Been Romeo;40703;0;0;Should've Been Romeo;0;0
3670;0;Family;Running Forever;28756;0;880;Running Forever;0;0
3671;5000000;Comedy Fantasy Horror Thriller;Yoga Hosers;8618793;0;880;Yoga Hosers;47;-5000000
3672;0;Horror Action;Navy Seals vs. Zombies;2394613;0;970;Navy Seals vs. Zombies;35;0
3673;0;Comedy Drama;Obsluhoval jsem anglického krále;2387463;0;1200;I Served the King of England;70;0
3674;5000000;Drama Comedy;Soul Kitchen;5461487;17872796;990;Soul Kitchen;71;12872796
3675;1000000;Drama;Sling Blade;1,48E+16;24475416;1350;Sling Blade;74;23475416
3676;4798235;Horror Thriller;The Awakening;2530216;209696;1070;The Awakening;63;-4588539
3677;4800000;Horror;Hostel;3,88E+16;80578934;940;Hostel;57;75778934
3678;0;Comedy Drama;A Cock and Bull Story;3,50E+16;0;940;A Cock and Bull Story;62;0
3679;5000000;Thriller Drama;Take Shelter;19807295;3099314;1200;Take Shelter;71;-1900686
3680;0;Horror Thriller;Lady in White;1435742;0;1120;Lady in White;63;0
3681;0;Drama Comedy;Driving Lessons;7,67E+16;0;980;Driving Lessons;63;0
3682;5000000;Comedy;Let's Kill Ward's Wife;8496364;0;810;Let's Kill Ward's Wife;55;-5000000
3683;4700000;Horror;The Texas Chainsaw Massacre 2;9617777;8025872;1010;The Texas Chainsaw Massacre 2;59;3325872
3684;4638783;Western;Pat Garrett & Billy the Kid;4,50E+16;11000000;1060;Pat Garrett & Billy the Kid;72;6361217
3685;4800000;Drama Thriller Crime;Only God Forgives;35754865;10337387;900;Only God Forgives;56;5537387
3686;0;Drama Romance;Camping Sauvage;20323;0;800;Camping Sauvage;48;0
3687;4;Comedy Romance;Without Men;28076;0;830;Without Men;46;-4
3688;0;Drama Family;Dear Frankie;3,11E+16;0;1050;Dear Frankie;70;0
3689;0;Action Comedy Drama Western;All Hat;137535;0;890;All Hat;10;0
3690;4600000;Drama Comedy Romance;Le Nom des gens;6368933;0;1000;The Names of Love;73;-4600000
3691;4700000;Drama Comedy;Treading Water;217538;0;920;Treading Water;56;-4700000
3692;4600000;Drama;Savage Grace;3,53E+16;0;970;Savage Grace;57;-4600000
3693;0;Drama;Out of the Blue;7,06E+15;0;1030;Out of the Blue;59;0
3694;4500000;Comedy Crime;Police Academy;15002502;146198896;960;Police Academy;65;141698896
3695;4500000;Romance Adventure Drama;The Blue Lagoon;22585384;58853106;1040;The Blue Lagoon;58;54353106
3696;6000000;Comedy Drama Romance;Four Weddings and a Funeral;2,98E+16;254700832;1170;Four Weddings and a Funeral;66;248700832
3697;4500000;Comedy;Fast Times at Ridgemont High;20403344;27092880;900;Fast Times at Ridgemont High;70;22592880
3698;4500000;Adventure Drama;Moby Dick;5224593;10400000;1160;Moby Dick;69;5900000
3699;15000000;Crime Drama;25th Hour;3,02E+15;13060843;1350;25th Hour;72;-1939157
3700;4500000;Crime Drama Romance Thriller;Bound;15359952;7011317;1080;Bound;69;2511317
3701;4500000;Crime Drama;Requiem for a Dream;11573034;7390108;1020;Requiem for a Dream;79;2890108
3702;0;Music Romance;State Fair;1847822;0;960;State Fair;62;0
3703;0;Drama Foreign Romance;Tango, no me dejes nunca;425551;0;1150;Tango;68;0
3704;4500000;Drama;Salvador;3,82E+16;0;1230;Salvador;70;-4500000
3705;5000000;Comedy;Moms' Night Out;10274542;10429707;980;Moms' Night Out;55;5429707
3706;6000000;Fantasy Drama Mystery;Donnie Darko;61210016;1270522;1130;Donnie Darko;77;-4729478
3707;0;Action Comedy Foreign;Salvando al Soldado Perez;1,77E+16;0;1050;Saving Private Perez;61;0
3708;4500000;Drama Foreign History;Karakter;1,17E+16;0;1220;Character;77;-4500000
3709;2000000;Comedy Crime Drama;Spun;6249262;0;1010;Spun;66;-2000000
3710;4500000;Comedy Drama;Life During Wartime;3,11E+16;744816;970;Life During Wartime;63;-3755184
3711;0;Drama Thriller;친절한 금자씨;1,71E+16;23803308;1150;Sympathy for Lady Vengeance;74;23803308
3712;0;Drama;Nannerl, la soeur de Mozart;774442;0;1200;Mozart's Sister;62;0
3713;0;Comedy Drama;Mean Machine;8816995;0;990;Mean Machine;60;0
3714;4500000;Action Crime Thriller;放‧逐;848639;0;1100;Exiled;70;-4500000
3715;0;Adventure Action Western;Blackthorn;5223096;623528;980;Blackthorn;66;623528
3716;0;Crime Drama;Lilja 4-Ever;7,76E+16;0;1090;Lilya 4-ever;77;0
3717;4500000;Drama Horror Mystery Thriller;After.Life;14570359;3606395;1040;After.Life;54;-893605
3718;0;Comedy Drama Thriller;Fugly;371337;0;1340;Fugly;53;0
3719;3000000;Drama;One Flew Over the Cuckoo's Nest;127525581;108981275;1330;One Flew Over the Cuckoo's Nest;82;105981275
3720;4400000;Comedy Horror;R.L. Stine's Monsterville: The Cabinet of Souls;3898737;0;850;R.L. Stine's Monsterville: The Cabinet of Souls;69;-4400000
3721;0;Comedy;Silent Movie;7,32E+16;0;860;Silent Movie;67;0
3722;4500000;Thriller Action Drama History;Airlift;2551559;32000000;1260;Airlift;73;27500000
3723;0;Drama Family;Anne of Green Gables;8772574;0;1990;Anne of Green Gables;82;0
3724;0;Adventure Action;Falcon Rising;6,99E+16;0;1030;Falcon Rising;55;0
3725;3730500;Action Drama Crime;The Sweeney;6,94E+15;6294161;1120;The Sweeney;57;2563661
3726;5000000;Crime Drama Thriller;Sexy Beast;1121273;0;890;Sexy Beast;70;-5000000
3727;0;Drama Thriller Crime;Snabba Cash;7217328;0;1240;Easy Money;65;0
3728;8000000;Drama Family;Whale Rider;1,24E+16;41400000;1010;Whale Rider;71;33400000
3729;3250000;Drama Family Foreign;Paa;2126139;0;1330;Paa;66;-3250000
3730;0;Thriller Mystery Science Fiction;Cargo;10142218;0;1200;Cargo;59;0
3731;4200000;Comedy Drama Family Music TV Movie;High School Musical;16536374;0;980;High School Musical;61;-4200000
3732;0;Drama Romance Foreign;Love and Death on Long Island;933891;0;930;Love and Death on Long Island;69;0
3733;4200000;Fantasy Action Thriller;Ночной дозор;1,25E+16;32000000;1140;Night Watch;63;27800000
3734;3705538;Romance Crime Drama Thriller;The Crying Game;8839651;62548947;1120;The Crying Game;69;58843409
3735;4000000;Comedy;Porky's;12891276;125728258;940;Porky's;61;121728258
3736;4000000;Horror Science Fiction;Survival of the Dead;10789912;0;900;Survival of the Dead;46;-4000000
3737;114000;Horror;Night of the Living Dead;25666029;30000000;960;Night of the Living Dead;75;29886000
3738;4000000;Drama;Lost in Translation;4566662;119723856;1020;Lost in Translation;73;115723856
3739;4000000;Comedy Drama Romance;Annie Hall;35892034;38251425;930;Annie Hall;78;34251425
3740;4000000;Action Drama Romance;The Greatest Show on Earth;8988455;36000000;1520;The Greatest Show on Earth;66;32000000
3741;4000000;Drama Romance;Monster's Ball;1,40E+16;44909486;1110;Monster's Ball;65;40909486
3742;4000000;Horror;Maggie;40016306;187112;950;Maggie;52;-3812888
3743;3600000;Drama Romance;Leaving Las Vegas;22030517;49800000;1120;Leaving Las Vegas;71;46200000
3744;4500000;Horror Comedy;Hansel and Gretel Get Baked;2503612;0;860;Hansel and Gretel Get Baked;48;-4500000
3745;4000000;Romance Drama Comedy;The Front Page;4117968;0;1050;The Front Page;69;-4000000
3746;4000000;Thriller;The Boy Next Door;24161735;52425855;910;The Boy Next Door;41;48425855
3747;4000000;Drama;Trapeze;1,38E+16;14400000;1050;Trapeze;64;10400000
3748;3500000;Comedy Drama;The Kids Are All Right;15338211;34705850;1060;The Kids Are All Right;65;31205850
3749;4000000;Action Horror Science Fiction Thriller;They Live;29852608;13008928;940;They Live;71;9008928
3750;4000000;Adventure Drama History Thriller War;The Great Escape;35061467;11744471;1720;The Great Escape;78;7744471
3751;0;Documentary;What the #$*! Do We (K)now!?;7,29E+16;10000000;1090;What the #$*! Do We (K)now!?;58;10000000
3752;5000000;Horror Thriller;The Last Exorcism Part II;10605752;15179302;880;The Last Exorcism Part II;44;10179302
3753;4000000;Drama;Boyhood;4340352;44349000;1640;Boyhood;75;40349000
3754;4000000;Comedy Mystery;Scoop;17229537;31584901;960;Scoop;64;27584901
3755;7000000;Action Comedy;The Wash;2453459;10229331;930;The Wash;53;3229331
3756;6000000;Action Comedy Romance;3 Strikes;1433692;9000000;820;3 Strikes;59;3000000
3757;32000000;Drama Romance;The Cooler;9976428;0;1010;The Cooler;67;-32000000
3758;4000000;Drama Action Romance;The Misfits;2,93E+16;8200000;1240;The Misfits;68;4200000
3759;0;Drama Thriller;The Night Listener;7,17E+15;0;910;The Night Listener;55;0
3760;0;Comedy Crime;The Jerky Boys;1,74E+16;0;820;The Jerky Boys;48;0
3761;0;Horror Drama Thriller;El orfanato;29071955;44000000;1050;The Orphanage;71;44000000
3762;0;Comedy Horror;A Haunted House 2;18428909;0;870;A Haunted House 2;54;0
3763;4000000;Comedy Drama Romance;The Rules of Attraction;11387335;0;1100;The Rules of Attraction;63;-4000000
3764;4000000;Action Drama Mystery Thriller;Topaz;5975604;6000000;1430;Topaz;61;2000000
3765;4000000;Comedy Crime;Let's Go to Prison;4,60E+15;4630045;840;Let's Go to Prison;55;630045
3766;4000000;Crime Comedy;Four Rooms;2287623;4300000;980;Four Rooms;65;300000
3767;4000000;Comedy Drama Romance;Secretary;19107285;9304609;1040;Secretary;67;5304609
3768;0;Documentary;The Real Cancun;4,56E+16;0;960;The Real Cancun;33;0
3769;4000000;Drama;Talk Radio;4541908;3468572;1100;Talk Radio;67;-531428
3770;0;Music Comedy;Waiting for Guffman;4348416;0;840;Waiting for Guffman;73;0
3771;0;Comedy Romance;Love Stinks;3,35E+16;0;940;Love Stinks;54;0
3772;4000000;Comedy Crime Thriller Romance;You Kill Me;6091951;2426851;900;You Kill Me;62;-1573149
3773;0;Comedy Drama;Thumbsucker;4757625;1919197;960;Thumbsucker;61;1919197
3774;4000000;Horror Action Thriller;Red State;12062371;1104682;880;Red State;59;-2895318
3775;4000000;Fantasy;Mirrormask;7,76E+16;866999;1010;Mirrormask;66;-3133001
3776;4000000;Drama Documentary;Samsara;1,28E+16;0;1020;Samsara;80;-4000000
3777;0;Fantasy Adventure;The Barbarians;1631993;0;870;The Barbarians;51;0
3778;0;Drama Romance;The Art of Getting By;12690224;1406224;830;The Art of Getting By;65;1406224
3779;0;Thriller Drama;Zipper;8516229;0;1030;Zipper;55;0
3780;0;Comedy Drama Thriller;Poolhall Junkies;590259;0;990;Poolhall Junkies;65;0
3781;4000000;Drama;The Loss of Sexual Innocence;2866934;0;1060;The Loss of Sexual Innocence;52;-4000000
3782;0;Drama Fantasy;Holy Motors;9140936;641100;1150;Holy Motors;69;641100
3783;4000000;Drama;Joe;22987897;2365467;1180;Joe;65;-1634533
3784;3000000;Crime Comedy Romance;Shooting Fish;1204941;302204;1090;Shooting Fish;70;-2697796
3785;1300000;Crime Drama Horror Thriller;Prison;7605291;354704;1020;Prison;67;-945296
3786;1500000;Comedy;Psycho Beach Party;2855963;0;950;Psycho Beach Party;60;-1500000
3787;0;Comedy Foreign;The Big Tease;502396;0;870;The Big Tease;58;0
3788;4000000;Drama;Guten Tag, Ramón;1771584;0;1190;Guten Tag, Ramón;81;-4000000
3789;9500000;Crime Drama Thriller;Trust;21230737;120000;1040;Trust;66;-9380000
3790;0;Comedy Crime;An Everlasting Piece;68246;0;1030;An Everlasting Piece;60;0
3791;0;Comedy Romance;Among Giants;541652;0;930;Among Giants;45;0
3792;16000000;Drama;Adore;18790221;318982;1000;Adore;61;-15681018
3793;4000000;Drama Romance;The Velocity of Gary;409089;0;1000;The Velocity of Gary;42;-4000000
3794;4000000;Drama;Los lunes al sol;3,66E+16;146402;1130;Mondays in the Sun;71;-3853598
3795;650000;Drama Horror Action Thriller Science Fiction;Stake Land;12496261;33245;980;Stake Land;62;-616755
3796;0;Drama;The Last Time I Committed Suicide;596889;0;920;The Last Time I Committed Suicide;67;0
3797;0;Drama;Praia do Futuro;2611364;0;1060;Futuro Beach;64;0
3798;4000000;Comedy Drama;Another Happy Day;3238466;355688;1190;Another Happy Day;62;-3644312
3799;4000000;Adventure Action Thriller Crime;A Lonely Place to Die;830723;25345000;990;A Lonely Place to Die;62;21345000
3800;0;Comedy Fantasy Science Fiction;Nothing;3408955;0;900;Nothing;58;0
3801;0;Drama;Географ глобус пропил;1,88E+16;4037782;1200;The Geographer Drank His Globe Away;73;4037782
3802;0;Drama Comedy History Music;1776;1,81E+16;0;1420;1776;71;0
3803;0;Thriller Romance;Inescapable;6783053;0;930;Inescapable;52;0
3804;3950000;Action Drama History;Hell's Angels;8484123;8000000;1270;Hell's Angels;61;4050000
3805;4000000;Comedy Drama Romance;Purple Violets;936232;0;1030;Purple Violets;57;-4000000
3806;4000000;Horror;The Veil;12822534;0;930;The Veil;45;-4000000
3807;0;Horror;The Loved Ones;4989985;0;840;The Loved Ones;66;0
3808;4000000;Horror;The Helpers;1390659;0;780;The Helpers;41;-4000000
3809;4000000;Comedy Romance TV Movie;How to Fall in Love;1923514;0;0;How to Fall in Love;52;-4000000
3810;0;Romance Adventure Drama;The Perfect Wave;4,12E+16;0;1130;The Perfect Wave;44;0
3811;3900000;Drama History;A Man for All Seasons;9541688;28350000;1200;A Man for All Seasons;75;24450000
3812;3800000;Drama;Network;17234745;23689877;1210;Network;77;19889877
3813;4000000;Drama Romance War;Gone with the Wind;4898255;400176459;2380;Gone with the Wind;77;396176459
3814;0;Drama;Desert Dancer;1972668;0;980;Desert Dancer;65;0
3815;3800000;War Western;Major Dundee;3490215;14873;1230;Major Dundee;62;-3785127
3816;3768785;Action Comedy Music Romance Western;Annie Get Your Gun;1726175;8000000;1070;Annie Get Your Gun;73;4231215
3817;967686;Comedy Crime Drama;Four Lions;20544999;4270000;1010;Four Lions;70;3302314
3818;0;Drama;Casa de Areia;389471;0;1150;The House of Sand;67;0
3819;3500000;Drama Action Comedy Crime;Defendor;845342;44462;1010;Defendor;65;-3455538
3820;3700000;Music Romance;The Pirate;90522;2956000;1020;The Pirate;66;-744000
3821;3800000;Drama Comedy Romance;The Good Heart;2201678;0;950;The Good Heart;60;-3800000
3822;4000000;Comedy Drama;The History Boys;3,77E+16;13401952;1090;The History Boys;66;9401952
3823;3600000;Drama;Midnight Cowboy;2,11E+16;44785053;1130;Midnight Cowboy;74;41185053
3824;3500000;Comedy;The Full Monty;17002623;257850122;910;The Full Monty;68;254350122
3825;3500000;Comedy;Airplane!;4,61E+16;83453539;880;Airplane!;71;79953539
3826;5000000;Thriller Adventure Action;Chain of Command;1398981;0;880;Chain of Command;53;-5000000
3827;3500000;Comedy;Friday;255748;28215918;910;Friday;70;24715918
3828;3500000;Drama Action Crime;Menace II Society;3,42E+16;27900000;970;Menace II Society;72;24400000
3829;3500000;Horror;Creepshow 2;10729884;14000000;920;Creepshow 2;59;10500000
3830;3716946;Action Comedy Western;The Ballad of Cable Hogue;2676535;5000000;1210;The Ballad of Cable Hogue;69;1283054
3831;3500000;Crime Drama;In Cold Blood;7,82E+16;13007551;1340;In Cold Blood;74;9507551
3832;3500000;Drama;The Nun's Story;3281509;12800000;1490;The Nun's Story;74;9300000
3833;3500000;Action Drama Thriller Crime Mystery;Harper;2938973;12000000;1210;Harper;62;8500000
3834;3500000;Crime Drama Mystery Thriller;Frenzy;10219942;12600000;1160;Frenzy;71;9100000
3835;3500000;Mystery Horror;The Witch;50319662;40423945;920;The Witch;63;36923945
3836;0;Action Comedy;I Got the Hook Up;593068;0;930;I Got the Hook Up;54;0
3837;3500000;Comedy Romance;She's the One;8406025;9482579;960;She's the One;57;5982579
3838;10000000;Drama;Gods and Monsters;5588652;6451628;1050;Gods and Monsters;68;-3548372
3839;2000000;Crime Drama Mystery Romance;El secreto de sus ojos;2,59E+16;33965843;1290;The Secret in Their Eyes;78;31965843
3840;0;Horror Thriller;Train;3,28E+16;0;940;Train;48;0
3841;3600000;Horror Comedy Fantasy;Evil Dead II;35674774;5923044;840;Evil Dead II;76;2323044
3842;0;Action Comedy;Pootie Tang;3115754;0;810;Pootie Tang;54;0
3843;1000000;TV Movie Horror;Sharknado;20466433;0;860;Sharknado;38;-1000000
3844;0;Drama Foreign;La otra conquista;15597;0;1050;The Other Conquest;54;0
3845;3500000;Fantasy Horror;Trolljegeren;12982319;4159678;1030;Troll Hunter;67;659678
3846;0;Comedy Romance;Ira & Abby;595136;0;1040;Ira & Abby;58;0
3847;3500000;Comedy Drama;Winter Passing;3643608;113783;980;Winter Passing;67;-3386217
3848;3500000;Action;D.E.B.S.;6396936;0;910;D.E.B.S.;56;-3500000
3849;0;Crime Action;The Masked Saint;909067;0;1110;The Masked Saint;29;0
3850;3500000;Crime Drama Mystery Thriller;The Betrayed;1348114;0;980;The Betrayed;52;-3500000
3851;0;Action Crime Comedy Thriller;Taxman;964802;0;1040;Taxman;20;0
3852;0;Drama;The Secret;4,23E+16;0;2000;The Secret;0;0
3853;3500000;Horror Thriller Mystery;02:13;1271621;0;960;02:13;46;-3500000
3854;3500000;Action Animation;Batman: The Dark Knight Returns, Part 2;25891466;0;780;Batman: The Dark Knight Returns, Part 2;79;-3500000
3855;3500000;Documentary;Time to Choose;1,62E+16;0;1000;Time to Choose;0;-3500000
3856;3500000;Action Adventure Drama Fantasy;In the Name of the King III;4304341;0;850;In the Name of the King III;33;-3500000
3857;3500000;Action Drama Thriller;Wicked Blood;3158056;0;920;Wicked Blood;53;-3500000
3858;0;Drama;Dawn Patrol;3230779;0;860;Stranded;50;0
3859;3440000;Crime Mystery Thriller;Lords of London;1913302;0;900;Lords of London;36;-3440000
3860;3400000;Comedy Music;High Anxiety;5690619;31063038;940;High Anxiety;65;27663038
3861;8000000;Documentary Family;La Marche de l'empereur;17537154;127392239;800;March of the Penguins;69;119392239
3862;3500000;Thriller Drama;Margin Call;2,63E+16;19504039;1070;Margin Call;67;16004039
3863;0;Drama;August;1,42E+16;0;1000;August;62;0
3864;3000000;Comedy Drama;Choke;11637458;3830137;920;Choke;60;830137
3865;3300000;Drama;Whiplash;192528841;13092000;1050;Whiplash;83;9792000
3866;3300000;Drama Crime;Cidade de Deus;44356711;30641770;1300;City of God;81;27341770
3867;600000;Comedy Drama;Human Traffic;4859873;4000000;990;Human Traffic;68;3400000
3868;3400000;Drama Music;To Write Love on Her Arms;6,72E+16;0;1180;To Write Love on Her Arms;68;-3400000
3869;0;Mystery Drama Crime Thriller;The Dead Girl;3069605;0;850;The Dead Girl;64;0
3870;3800000;Drama;Jagten;21826888;16800000;1150;The Hunt;79;13000000
3871;0;Comedy Family;A Christmas Story;15128316;19294144;940;A Christmas Story;74;19294144
3872;0;Drama Romance;Bella;1814802;0;910;Bella;67;0
3873;4300000;Action Drama Horror Crime Thriller;Class of 1984;5643023;0;980;Class of 1984;62;-4300000
3874;3300000;Comedy;Opposite Sex;2964785;45000;960;The Opposite Sex;41;-3255000
3875;2000000;Romance Drama;Dreaming of Joseph Lees;11615;7;920;Dreaming of Joseph Lees;80;-1999993
3876;0;Drama;Entre les murs;1,34E+16;28814580;1280;The Class;68;28814580
3877;3200000;Horror Drama Mystery;Rosemary's Baby;26180367;33395426;1360;Rosemary's Baby;75;30195426
3878;3200000;Western;The Man Who Shot Liberty Valance;11735287;8000000;1230;The Man Who Shot Liberty Valance;74;4800000
3879;0;Drama Romance;Adam;8308442;2277396;990;Adam;69;2277396
3880;0;Drama Thriller Crime;María, llena eres de gracia;3027892;0;1010;Maria Full of Grace;69;0
3881;3200000;Drama Romance Comedy;Beginners;1,19E+16;5332926;1050;Beginners;68;2132926
3882;0;Action Comedy Horror;Feast;8825113;658573;950;Feast;61;658573
3883;2700000;Comedy;Animal House;17332585;141000000;1090;Animal House;70;138300000
3884;2500000;Adventure Action Thriller;Goldfinger;47812466;124881062;1100;Goldfinger;72;122381062
3885;2400000;Science Fiction Horror;Antiviral;11753553;0;1100;Antiviral;57;-2400000
3886;3180000;Drama Family Fantasy;It's a Wonderful Life;42868495;9644124;1300;It's a Wonderful Life;80;6464124
3887;4000000;Drama Crime;Trainspotting;63513324;16491080;930;Trainspotting;78;12491080
3888;0;Comedy;The Original Kings of Comedy;1918959;0;1150;The Original Kings of Comedy;63;0
3889;3000000;Horror Thriller;Paranormal Activity 2;22789649;177512032;910;Paranormal Activity 2;57;174512032
3890;0;Comedy Romance;Waking Ned;5735912;0;910;Waking Ned;74;0
3891;4000000;Documentary;Bowling for Columbine;11414843;35564473;1200;Bowling for Columbine;73;31564473
3892;0;Drama;归来;6017273;0;1110;Coming Home;69;0
3893;3000000;Horror;A Nightmare on Elm Street Part 2: Freddy's Revenge;21607228;29999213;870;A Nightmare on Elm Street Part 2: Freddy's Revenge;57;26999213
3894;3000000;Drama Romance;A Room with a View;7,96E+16;20966644;1170;A Room with a View;69;17966644
3895;3000000;Science Fiction Horror Thriller;The Purge;5,44E+15;89328627;860;The Purge;60;86328627
3896;3000000;Horror Thriller Mystery;Sinister;41045084;77712439;1100;Sinister;67;74712439
3897;3000000;Comedy;Martin Lawrence Live: Runteldat;2,95E+16;19184015;1130;Martin Lawrence Live: Runteldat;50;16184015
3898;3000000;Drama Romance;Cat on a Hot Tin Roof;16553594;17570324;1080;Cat on a Hot Tin Roof;76;14570324
3899;3000000;Adventure Science Fiction Mystery;Beneath the Planet of the Apes;24393296;18999718;950;Beneath the Planet of the Apes;62;15999718
3900;3000000;Comedy Family Drama;Air Bud;11241802;23144499;980;Air Bud;53;20144499
3901;16000000;Adventure Fantasy Animation Action Family;Pokémon 3: The Movie;918885;68411275;930;Pokémon: Spell of the Unknown;59;52411275
3902;3000000;Horror Mystery Thriller;Friday the 13th Part VI: Jason Lives;11158167;19472057;860;Friday the 13th Part VI: Jason Lives;57;16472057
3903;3000000;Drama History War;The Bridge on the River Kwai;23109959;33300000;1610;The Bridge on the River Kwai;77;30300000
3904;3000000;Comedy Family Science Fiction;Spaced Invaders;1586598;15369573;1000;Spaced Invaders;47;12369573
3905;2000000;Comedy Crime Thriller;Family Plot;3,83E+16;7900000;1210;Family Plot;67;5900000
3906;3000000;Comedy Drama Romance;The Apartment;22889294;25000000;1250;The Apartment;81;22000000
3907;3000000;Fantasy Horror Thriller;Jason Goes to Hell: The Final Friday;1,03E+16;15938065;870;Jason Goes to Hell: The Final Friday;42;12938065
3908;3000000;Mystery Thriller;Torn Curtain;7,92E+15;13000000;1280;Torn Curtain;64;10000000
3909;3000000;Comedy Documentary Music;Dave Chappelle's Block Party;1697846;11718595;1000;Dave Chappelle's Block Party;64;8718595
3910;0;Romance Thriller Western;Slow West;1,49E+16;229094;840;Slow West;66;229094
3911;3000000;Drama Music Romance;Krush Groove;720091;0;970;Krush Groove;70;-3000000
3912;0;Action Comedy Crime;Next Day Air;2747402;0;840;Next Day Air;53;0
3913;3000000;Drama;Elmer Gantry;6,73E+15;10400000;1460;Elmer Gantry;73;7400000
3914;3000000;Drama History;Judgment at Nuremberg;13338539;10000000;1860;Judgment at Nuremberg;76;7000000
3915;0;Comedy Romance;Trippin';185373;9016377;940;Trippin';45;9016377
3916;3000000;Western;Red River;5,34E+16;9012000;1330;Red River;73;6012000
3917;0;Comedy Romance;Phat Girlz;9,83E+15;0;990;Phat Girlz;37;0
3918;3000000;Romance Drama;Before Midnight;23299907;11176469;1080;Before Midnight;74;8176469
3919;0;Comedy Fantasy Family;Teen Wolf Too;4103764;0;950;Teen Wolf Too;38;0
3920;3000000;Action Horror Science Fiction Thriller;Phantasm II;5003615;7282851;970;Phantasm II;63;4282851
3921;3000000;Drama;Woman Thou Art Loosed;2,00E+16;6804016;940;Woman Thou Art Loosed;50;3804016
3922;0;Comedy Drama;Real Women Have Curves;1026243;0;860;Real Women Have Curves;58;0
3923;0;Drama Foreign Romance;Water;2787375;10422387;1150;Water;68;10422387
3924;3800000;Comedy;East Is East;3,67E+16;28200000;970;East Is East;65;24400000
3925;3000000;Comedy Romance;Whipped;2144354;0;820;Whipped;31;-3000000
3926;3000000;Drama History Romance;Kama Sutra - A Tale of Love;3937939;4109095;1170;Kama Sutra - A Tale of Love;57;1109095
3927;3000000;Comedy Drama;Please Give;5325156;0;900;Please Give;60;-3000000
3928;3000000;Family Fantasy;Willy Wonka & the Chocolate Factory;23981601;4000000;1000;Willy Wonka & the Chocolate Factory;74;1000000
3929;0;Fantasy Horror Science Fiction;Warlock: The Armageddon;3107149;0;980;Warlock: The Armageddon;52;0
3930;0;Comedy Crime;8 Heads in a Duffel Bag;5016607;0;950;8 Heads in a Duffel Bag;54;0
3931;0;Drama Romance;Days of Heaven;13857194;0;940;Days of Heaven;76;0
3932;0;Drama;Thirteen Conversations About One Thing;6997495;0;1040;Thirteen Conversations About One Thing;64;0
3933;3000000;Comedy;Jawbreaker;4337685;3076820;870;Jawbreaker;59;76820
3934;2962051;Drama History;Basquiat;3,64E+16;3011195;1080;Basquiat;66;49144
3935;0;Comedy Drama;Frances Ha;15492257;4069826;860;Frances Ha;72;4069826
3936;3000000;Crime Drama;Tsotsi;2504169;9879971;940;Tsotsi;69;6879971
3937;3000000;Comedy Drama;Happiness;10757539;2807390;1390;Happiness;74;-192610
3938;0;Comedy Documentary;DysFunktional Family;1580027;0;890;DysFunktional Family;61;0
3939;2800000;Comedy Horror;Tusk;1,58E+16;1826705;1020;Tusk;51;-973295
3940;3000000;Drama Thriller Mystery Action;올드보이;5,68E+16;14980005;1200;Oldboy;80;11980005
3941;0;Action Drama Family Thriller;Letters to God;3,64E+16;0;1100;Letters to God;65;0
3942;3000000;Action Comedy Thriller;Hobo with a Shotgun;16900433;748453;860;Hobo with a Shotgun;57;-2251547
3943;3000000;Action Comedy;Compadres;1569246;0;1010;Compadres;52;-3000000
3944;3000000;Comedy Drama Thriller;Freeway;4682881;0;1100;Freeway;65;-3000000
3945;0;TV Movie Action Drama Family;Love's Abiding Joy;1128559;0;870;Love's Abiding Joy;58;0
3946;3000000;Drama;Fish Tank;1268672;2357852;1230;Fish Tank;69;-642148
3947;0;Comedy Romance;Damsels in Distress;3,75E+16;0;990;Damsels in Distress;56;0
3948;0;Horror Science Fiction Thriller;Creature;2857848;0;1760;Creature;40;0
3949;3000000;Comedy Romance;Bachelorette;2,10E+16;11947954;870;Bachelorette;53;8947954
3950;0;Drama Music Family;Brave New Girl;1,81E+16;0;1200;Brave New Girl;37;0
3951;0;Comedy;Tim and Eric's Billion Dollar Movie;175311;0;940;Tim and Eric's Billion Dollar Movie;52;0
3952;2700000;Comedy Drama;Sommersturm;3120747;0;980;Summer Storm;67;-2700000
3953;0;War Drama History;Fort McCoy;384496;0;0;Fort McCoy;63;0
3954;0;Horror Thriller;Chain Letter;2504156;0;960;Chain Letter;39;0
3955;3000000;Drama Comedy;Just Looking;431332;0;970;Just Looking;58;-3000000
3956;3000000;Science Fiction;The Divide;1,19E+16;22000;1120;The Divide;57;-2978000
3957;0;Drama Horror Romance;The Eclipse;9,34E+15;0;880;The Eclipse;61;0
3958;3000000;Thriller Horror;Demonic;12564554;3387000;830;Demonic;49;387000
3959;0;Comedy;My Big Fat Independent Movie;6,88E+15;0;800;My Big Fat Independent Movie;30;0
3960;0;Comedy Family;The Deported;194848;0;900;The Deported;0;0
3961;0;Drama;Tanner Hall;2015525;0;960;Tanner Hall;54;0
3962;3000000;Action Drama Thriller;Open Road;2680629;0;850;Open Road;52;-3000000
3963;0;Comedy;They Came Together;1,20E+16;0;840;They Came Together;53;0
3964;0;Comedy;30 Nights of Paranormal Activity With the Devil Inside the Girl With the Dragon Tattoo;1737032;0;800;30 Nights of Paranormal Activity With the Devil Inside the Girl With the Dragon Tattoo;29;0
3965;3000000;Drama Action;Never Back Down 2: The Beatdown;9249229;0;900;Never Back Down 2: The Beatdown;58;-3000000
3966;2500000;Action Crime Drama Thriller;Point Blank;5164423;3200000;920;Point Blank;71;700000
3967;3;Drama Comedy;Four Single Fathers;8263;0;1000;Four Single Fathers;0;-3
3968;0;Thriller;Enter the Dangerous Mind;2,00E+16;0;880;Enter the Dangerous Mind;48;0
3969;3000000;Mystery Thriller;Something Wicked;1968679;0;950;Something Wicked;46;-3000000
3970;3000000;Thriller;AWOL-72;1141463;0;790;AWOL-72;28;-3000000
3971;0;;Iguana;214704;0;880;Iguana;60;0
3972;3200000;Action Crime Thriller;Chicago Overcoat;1034844;0;950;Chicago Overcoat;61;-3200000
3973;0;Comedy Drama Romance;Barry Munday;1975941;0;950;Barry Munday;63;0
3974;2900000;Drama;Central do Brasil;5928937;5596708;1130;Central Station;76;2696708
3975;2900000;Comedy Drama;Pocketful of Miracles;3370225;5000000;1360;Pocketful of Miracles;73;2100000
3976;0;Crime Action;Close Range;5485217;0;800;Close Range;49;0
3977;0;Comedy Drama Romance;Boynton Beach Club;18887;0;1050;Boynton Beach Club;68;0
3978;3000000;Thriller Mystery Drama Horror;Amnesiac;3,08E+16;0;900;Amnesiac;41;-3000000
3979;3000000;Documentary;Freakonomics;1,78E+16;103735;930;Freakonomics;66;-2896265
3980;0;Horror Thriller Mystery;Haute tension;4,95E+16;0;910;High Tension;66;0
3981;2902660;Romance Comedy Drama;Griff the Invisible;1,35E+16;0;930;Griff the Invisible;61;-2902660
3982;0;Thriller Action Horror;Unnatural;687656;0;890;Unnatural;43;0
3983;8000000;Drama;Hustle & Flow;639503;23563727;1160;Hustle & Flow;69;15563727
3984;2883848;Comedy Romance;Some Like It Hot;3930982;25000000;1220;Some Like It Hot;80;22116152
3985;2800000;Horror Thriller;Friday the 13th Part VII: The New Blood;9,07E+15;19170001;880;Friday the 13th Part VII: The New Blood;53;16370001
3986;2777000;Adventure Family Fantasy;The Wizard of Oz;67417542;33754967;1020;The Wizard of Oz;74;30977967
3987;2800000;Comedy Science Fiction;Young Frankenstein;36444894;86273333;1060;Young Frankenstein;77;83473333
3988;2000000;Horror Action Science Fiction;Diary of the Dead;15351412;5364858;950;Diary of the Dead;54;3364858
3989;0;Comedy Drama Romance;Lage Raho Munna Bhai;2436019;0;1440;Lage Raho Munna Bhai;76;0
3990;0;Drama;Ulee's Gold;9,34E+15;0;1120;Ulee's Gold;65;0
3991;2700000;Adventure Family;The Black Stallion;1135972;37799643;1180;The Black Stallion;70;35099643
3992;0;;Sardaarji;296981;0;0;Sardaarji;95;0
3993;0;Action Adventure Animation Comedy Science Fiction;Rejsen til Saturn;1,78E+16;0;900;Journey to Saturn;49;0
3994;2686000;Adventure Comedy Romance;Donovan's Reef;1,90E+16;6600000;1090;Donovan's Reef;60;3914000
3995;0;Comedy Drama;De jurk;144031;0;1030;The Dress;70;0
3996;2627000;Drama Romance War;A Guy Named Joe;5,31E+15;5363000;1200;A Guy Named Joe;60;2736000
3997;2600000;Western Comedy;Blazing Saddles;2,28E+16;119500000;930;Blazing Saddles;72;116900000
3998;2600000;Horror Thriller;Friday the 13th: The Final Chapter;1,40E+16;32980880;910;Friday the 13th: The Final Chapter;59;30380880
3999;2159280;Drama;Ida;13265432;10700000;800;Ida;71;8540720
4000;0;Drama Romance;Maurice;11552247;0;1340;Maurice;71;0
4001;0;Comedy;Beer League;173892;0;860;Beer League;53;0
4002;2600000;Documentary;Riding Giants;8,96E+15;3166000;1050;Riding Giants;76;566000
4003;2600000;Science Fiction Thriller;Los cronocrímenes;1902965;553198;920;Timecrimes;70;-2046802
4004;0;Action Adventure Comedy Drama Foreign;疯狂的赛车;406645;0;990;Silver Medalist;74;0
4005;2600000;Horror Thriller;Timber Falls;3,69E+16;0;970;Timber Falls;52;-2600000
4006;2540800;Comedy Music Romance;Singin' in the Rain;36556954;7200000;1030;Singin' in the Rain;78;4659200
4007;0;Documentary;Fat, Sick & Nearly Dead;545825;0;970;Fat, Sick & Nearly Dead;71;0
4008;2500000;Comedy Horror;A Haunted House;18661541;60141683;860;A Haunted House;54;57641683
4009;2500000;Documentary;2016: Obama's America;973582;33400000;870;2016: Obama's America;46;30900000
4010;0;Comedy Drama;That Thing You Do!;14885388;34585416;1080;That Thing You Do!;68;34585416
4011;2500000;Horror Mystery Science Fiction;Halloween III: Season of the Witch;12030456;14400000;980;Halloween III: Season of the Witch;50;11900000
4012;2500000;Action Science Fiction;Escape from the Planet of the Apes;1830961;12348905;980;Escape from the Planet of the Apes;63;9848905
4013;2500000;Action Drama Western;Hud;682919;10000000;1120;Hud;75;7500000
4014;0;Comedy Documentary;Kevin Hart: Let Me Explain;9799357;32230907;740;Kevin Hart: Let Me Explain;71;32230907
4015;2500000;Drama Romance;My Own Private Idaho;10363642;0;1040;My Own Private Idaho;71;-2500000
4016;2500000;Comedy Drama Romance;Garden State;3,06E+16;26781723;1020;Garden State;71;24281723
4017;2500000;Drama Romance;Before Sunrise;2,37E+16;5535405;1050;Before Sunrise;77;3035405
4018;0;Horror Mystery Thriller;Sur le seuil;2,05E+16;0;1000;Evil Words;69;0
4019;0;Comedy Drama Romance;Jesus' Son;5581743;0;1070;Jesus' Son;67;0
4020;0;Comedy Romance;Saving Face;2,49E+16;0;910;Saving Face;68;0
4021;0;Drama;Brick Lane;262135;0;1020;Brick Lane;52;0
4022;2500000;Science Fiction Comedy Drama Crime;Robot & Frank;23419061;3325038;850;Robot & Frank;68;825038
4023;0;Drama Romance;My Life Without Me;7958831;9726954;1060;My Life Without Me;72;9726954
4024;2500000;Comedy Drama Romance;The Spectacular Now;2,57E+16;6854611;950;The Spectacular Now;68;4354611
4025;0;Comedy Documentary;Religulous;9,77E+15;0;1010;Religulous;72;0
4026;0;Documentary Drama;Fuel;197469;0;900;Fuel;70;0
4027;0;Drama;Valley of the Heart's Delight;142255;0;1000;Valley of the Heart's Delight;70;0
4028;2500000;Drama;Eye of the Dolphin;3,02E+16;71904;1000;Eye of the Dolphin;71;-2428096
4029;0;Documentary;8: The Mormon Proposition;424957;0;800;8: The Mormon Proposition;55;0
4030;14000000;Comedy Romance;The Other End of the Line;3393648;0;1060;The Other End of the Line;61;-14000000
4031;0;Horror Thriller;Anatomie;5025938;0;1030;Anatomy;61;0
4032;2500000;Drama Science Fiction Thriller;Sleep Dealer;4624691;107559;900;Sleep Dealer;60;-2392441
4033;2500000;Comedy Action Drama;Super;1,22E+16;324138;960;Super;66;-2175862
4034;0;Comedy Family;Christmas Mail;6,30E+15;0;890;Christmas Mail;50;0
4035;2500000;Comedy Horror;Stung;4,27E+16;0;870;Stung;49;-2500000
4036;35000000;Horror;Antibirth;3674294;0;940;Antibirth;48;-35000000
4037;2400000;Drama;Get on the Bus;4623059;5731103;1200;Get on the Bus;70;3331103
4038;0;Drama Horror Thriller;Thr3e;1,95E+16;0;1010;Thr3e;48;0
4039;30000000;Adventure Comedy Science Fiction;Idiocracy;27940093;495303;840;Idiocracy;63;-29504697
4040;2500000;Crime;The Rise of the Krays;1,76E+16;0;1100;The Rise of the Krays;45;-2500000
4041;2380000;Drama Crime;This Is England;8395624;8176544;1010;This Is England;74;5796544
4042;2500000;Action Adventure Science Fiction;U.F.O.;8248149;0;1010;U.F.O.;31;-2500000
4043;2361000;Comedy Music;Bathing Beauty;628051;6892000;1010;Bathing Beauty;70;4531000
4044;2450000;Drama Family;Go for It!;500753;0;1050;Go for It!;46;-2450000
4045;0;Comedy Drama Family;Dancer, Texas Pop. 81;376662;565592;970;Dancer, Texas Pop. 81;100;565592
4046;2300000;Music Romance;Show Boat;1606314;11000000;1070;Show Boat;69;8700000
4047;0;Drama;Redemption Road;1,97E+16;0;910;Redemption Road;47;0
4048;0;Thriller;The Calling;5759493;0;1080;The Calling;56;0
4049;2000000;Fantasy Adventure Animation Comedy Family;The Brave Little Toaster;686302;0;900;The Brave Little Toaster;67;-2000000
4050;2280000;Animation Family Music;Fantasia;32875469;83320000;1240;Fantasia;72;81040000
4051;0;Thriller Drama;8 Days;15295;0;900;8 Days;0;0
4052;4000000;Horror Thriller;Friday the 13th Part III;14206525;36690067;950;Friday the 13th Part III;57;32690067
4053;2200000;Horror Thriller;Friday the 13th: A New Beginning;12639469;21930418;920;Friday the 13th: A New Beginning;51;19730418
4054;0;Drama;The Last Sin Eater;2371477;0;1170;The Last Sin Eater;62;0
4055;0;Fantasy Drama;Do You Believe?;2470443;0;1150;Do You Believe?;66;0
4056;0;Thriller Romance;Impact Point;1532518;0;900;Impact Point;57;0
4057;2160000;Drama;The Valley of Decision;1813;9132000;1190;The Valley of Decision;58;6972000
4058;2300000;Thriller Drama;Eden;2713171;0;970;Eden;56;-2300000
4059;0;Comedy Romance Foreign;Chicken Tikka Masala;258413;0;900;Chicken Tikka Masala;35;0
4060;0;Romance Comedy Music;There's Always Woodstock;2,03E+16;0;900;There's Always Woodstock;54;0
4061;0;Action Comedy Horror;Jack Brooks: Monster Slayer;2,66E+16;0;850;Jack Brooks: Monster Slayer;57;0
4062;2100000;Drama History Romance;The Best Years of Our Lives;838717;23650000;1720;The Best Years of Our Lives;76;21550000
4063;0;Crime Drama;Bully;6,68E+16;480811;1130;Bully;67;480811
4064;0;Comedy Drama;Elling;2,53E+16;0;890;Elling;70;0
4065;2100000;Drama Crime;Mi America;39007;3330;1260;Mi America;0;-2096670
4066;1500000;Horror Mystery;[REC];3,17E+16;30448000;780;[REC];71;28948000
4067;0;Drama Mystery Thriller;Lies in Plain Sight;4,79E+16;0;880;Lies in Plain Sight;45;0
4068;0;;Sharkskin;27801;0;0;Sharkskin;0;0
4069;0;Thriller Horror Science Fiction;Containment;2122451;0;770;Containment;51;0
4070;0;Adventure Drama Western;The Timber;803761;0;810;The Timber;41;0
4071;2000000;Action Thriller Adventure;From Russia with Love;4,13E+16;78898765;1150;From Russia with Love;69;76898765
4072;0;Comedy Horror Action;The Toxic Avenger Part II;1,79E+16;0;960;The Toxic Avenger Part II;53;0
4073;2000000;Comedy Romance Science Fiction;Sleeper;1,07E+16;18344729;890;Sleeper;70;16344729
4074;2000000;Horror Thriller;It Follows;1,01E+16;14674076;1000;It Follows;66;12674076
4075;2000000;Comedy;Everything You Always Wanted to Know About Sex *But Were Afraid to Ask;13223111;18016290;880;Everything You Always Wanted to Know About Sex *But Were Afraid to Ask;66;16016290
4076;2000000;Crime Drama;To Kill a Mockingbird;22139842;13129846;1290;To Kill a Mockingbird;80;11129846
4077;2000000;Adventure Action Thriller Science Fiction;Mad Max 2;37117362;24600832;950;Mad Max 2: The Road Warrior;73;22600832
4078;0;Action Comedy;醉拳二;15046612;0;1020;The Legend of Drunken Master;72;0
4079;2000000;Crime Drama;Boys Don't Cry;1,56E+16;11540607;1180;Boys Don't Cry;72;9540607
4080;2000000;Horror Mystery;Silent House;1,17E+16;13101672;850;Silent House;52;11101672
4081;2000000;Drama Thriller;Das Leben der Anderen;34938177;70000000;1370;The Lives of Others;79;68000000
4082;1000000;Drama;Courageous;5961119;34522221;1290;Courageous;68;33522221
4083;2000000;Drama;The Hustler;17639478;7600000;1340;The Hustler;76;5600000
4084;2000000;Adventure Drama Romance;Boom Town;1867004;9172000;1190;Boom Town;65;7172000
4085;8000000;Adventure Animation Comedy Drama;Les triplettes de Belleville;1,39E+16;1477676;800;The Triplets of Belleville;73;-6522324
4086;0;Drama Comedy;Smoke Signals;2304552;0;890;Smoke Signals;66;0
4087;0;Comedy Drama;American Splendor;7792851;6003587;1010;American Splendor;71;6003587
4088;2700000;Drama Romance;Before Sunset;1,48E+16;15992615;800;Before Sunset;76;13292615
4089;2000000;Drama Thriller;Amores perros;23281616;20908467;1540;Amores perros;76;18908467
4090;2000000;Crime Drama;Thirteen;2,03E+16;4601043;1000;Thirteen;67;2601043
4091;2000000;Drama Romance;Gentleman's Agreement;5381536;7800000;1180;Gentleman's Agreement;68;5800000
4092;2000000;Drama;Winter's Bone;2,08E+16;13831503;1000;Winter's Bone;68;11831503
4093;0;Documentary Action Adventure;Touching the Void;1,40E+16;13885802;1060;Touching the Void;76;13885802
4094;2000000;Drama Music Romance;Alexander's Ragtime Band;4,84E+16;4000000;1060;Alexander's Ragtime Band;48;2000000
4095;0;Comedy Drama;Me and You and Everyone We Know;9719094;0;900;Me and You and Everyone We Know;70;0
4096;2000000;Documentary;Inside Job;16930914;7871522;1090;Inside Job;77;5871522
4097;6000000;Drama Music Romance;We Are Your Friends;2,88E+16;11122090;960;We Are Your Friends;63;5122090
4098;0;Crime Drama;Ghost Dog: The Way of the Samurai;18223139;0;1160;Ghost Dog: The Way of the Samurai;72;0
4099;2000000;Crime Drama Thriller Action;Harsh Times;12999023;5967038;1200;Harsh Times;63;3967038
4100;2000000;Crime Drama Thriller;Captive;6,73E+16;2801508;970;Captive;56;801508
4101;2000000;Comedy Drama Romance;Full Frontal;1,96E+16;2506446;960;Full Frontal;48;506446
4102;0;Horror;Witchboard;7,15E+15;0;980;Witchboard;59;0
4103;2000000;Romance Drama Comedy;Shortbus;1,48E+16;5179037;1010;Shortbus;63;3179037
4104;2000000;Drama Animation War;Vals Im Bashir;1,41E+16;11125849;900;Waltz with Bashir;78;9125849
4105;2000000;;The Book of Mormon Movie, Volume 1: The Journey;31947;1672730;1200;The Book of Mormon Movie, Volume 1: The Journey;50;-327270
4106;2000000;Documentary;No End in Sight;2,28E+16;1431623;1020;No End in Sight;72;-568377
4107;2000000;Drama Romance;The Diary of a Teenage Girl;18224326;1477002;980;The Diary of a Teenage Girl;68;-522998
4108;2000000;Documentary;In the Shadow of the Moon;3,43E+16;0;1090;In the Shadow of the Moon;76;-2000000
4109;0;Drama Western;Meek's Cutoff;4749885;876302;1040;Meek's Cutoff;65;876302
4110;2000000;History Documentary;Inside Deep Throat;3,98E+16;653621;920;Inside Deep Throat;68;-1346379
4111;0;Drama Action Thriller;Dinner Rush;1096355;0;990;Dinner Rush;71;0
4112;0;Comedy Drama;Clockwatchers;1196943;0;960;Clockwatchers;56;0
4113;2000000;Comedy;The Virginity Hit;3125382;563706;1200;The Virginity Hit;46;-1436294
4114;2000000;Action Thriller;Subway;5261065;390659;1040;Subway;63;-1609341
4115;0;Comedy Drama;House of D;6,34E+16;0;970;House of D;61;0
4116;0;Comedy Horror;Teeth;7359286;0;940;Teeth;52;0
4117;2000000;Action Adventure Science Fiction;Six-String Samurai;1,89E+16;124494;910;Six-String Samurai;58;-1875506
4118;0;;Hum To Mohabbat Karega;1186;0;0;Hum To Mohabbat Karega;0;0
4119;2000000;Drama Comedy Music;It's All Gone Pete Tong;3,91E+16;120620;900;It's All Gone Pete Tong;71;-1879380
4120;3800000;Comedy;Saint John of Las Vegas;2559806;111731;840;Saint John of Las Vegas;59;-3688269
4121;0;Comedy Drama Romance;24 7: Twenty Four Seven;744406;0;960;24 7: Twenty Four Seven;63;0
4122;13500000;Drama;Stonewall;516023;187674;1290;Stonewall;52;-13312326
4123;7000000;Animation Family Foreign;Roadside Romeo;2,54E+16;1100000;930;Roadside Romeo;67;-5900000
4124;0;Drama Action Thriller;This Thing of Ours;46868;0;1000;This Thing of Ours;50;0
4125;0;Adventure Family;The Lost Medallion: The Adventures of Billy Stone;2952932;0;970;The Lost Medallion: The Adventures of Billy Stone;56;0
4126;0;Comedy Drama Music Romance;The Last Five Years;5563068;0;940;The Last Five Years;55;0
4127;0;Comedy Drama Mystery Thriller;The Missing Person;1,16E+16;0;950;The Missing Person;64;0
4128;2000000;Comedy Science Fiction Romance Horror;Return of the Living Dead 3;7502934;54207;970;Return of the Living Dead 3;59;-1945793
4129;0;Drama Action Romance;London;5350423;0;920;London;61;0
4130;2000000;Drama;Sherrybaby;4,26E+15;622806;960;Sherrybaby;63;-1377194
4131;0;Horror Science Fiction;Circle;6752141;0;870;Circle;60;0
4132;0;Horror Thriller;Eden Lake;20362373;3983997;910;Eden Lake;67;3983997
4133;0;Thriller;Plush;5099368;0;980;Plush;54;0
4134;0;Horror Comedy;Lesbian Vampire Killers;6,63E+15;0;860;Lesbian Vampire Killers;53;0
4135;0;Drama Action Crime Foreign;Jerusalema;1,72E+16;0;1200;Gangster's Paradise: Jerusalema;68;0
4136;0;Thriller Drama Crime;Freeze Frame;4922397;0;990;Freeze Frame;69;0
4137;1000000;Thriller Horror;Grave Encounters;13222268;0;920;Grave Encounters;61;-1000000
4138;100000;Horror;Stitches;7,45E+15;95000;860;Stitches;55;-5000
4139;2000000;Crime Drama Horror Thriller;Nine Dead;968793;0;980;Nine Dead;52;-2000000
4140;2;Documentary;To Be Frank, Sinatra at 100;50625;0;;To Be Frank, Sinatra at 100;0;-2
4141;2000000;Comedy;Bananas;5941852;11833696;820;Bananas;67;9833696
4142;0;Thriller;$upercapitalist;174311;0;1030;Supercapitalist;35;0
4143;0;Action Adventure Drama;Rockaway;361554;0;760;Rockaway;58;0
4144;2300000;Crime Drama Mystery;The Lady from Shanghai;8,06E+15;0;870;The Lady from Shanghai;72;-2300000
4145;2000000;Horror Thriller;No Man's Land: The Rise of Reeker;4346271;0;880;No Man's Land: The Rise of Reeker;44;-2000000
4146;14000000;Action Adventure Drama;Highway;3419685;0;970;Highway;56;-14000000
4147;2000000;Comedy Crime;Small Apartments;5100741;0;960;Small Apartments;57;-2000000
4148;0;Comedy;Coffee Town;2253589;0;870;Coffee Town;67;0
4149;0;Comedy Fantasy Music;The Ghastly Love of Johnny X;209475;0;1060;The Ghastly Love of Johnny X;66;0
4150;0;Comedy Drama;All Is Bright;3613577;0;1070;All Is Bright;53;0
4151;0;Mystery Horror History;Die Schlangengrube und das Pendel;1296784;0;850;The Torture Chamber of Dr. Sadism;63;0
4152;7000000;Comedy Drama;Straight A's;4,51E+16;0;880;Straight A's;52;-7000000
4153;0;Comedy Music;A Funny Thing Happened on the Way to the Forum;8,90E+15;0;990;A Funny Thing Happened on the Way to the Forum;61;0
4154;0;Documentary;Slacker Uprising;1619635;0;1020;Slacker Uprising;59;0
4155;0;Action Adventure History Western;The Legend of Hell's Gate: An American Conspiracy;1002585;0;1080;The Legend of Hell's Gate: An American Conspiracy;39;0
4156;0;Science Fiction Comedy;Walking with the Dead;1332804;0;900;The Walking Deceased;42;0
4157;2000000;Thriller Mystery Horror Drama;The Curse of Downers Grove;200163;0;890;The Curse of Downers Grove;44;-2000000
4158;2000000;Thriller;Shark Lake;1187764;0;920;Shark Lake;44;-2000000
4159;19000000;Crime Drama;River's Edge;6463806;0;990;River's Edge;67;-19000000
4160;0;Fantasy Drama Science Fiction;Northfork;1,98E+16;0;1030;Northfork;67;0
4161;1950000;Thriller Action;The Marine 4: Moving Target;3,70E+16;0;900;The Marine 4: Moving Target;58;-1950000
4162;1987650;Drama Thriller Mystery;Buried;32841229;19152480;940;Buried;66;17164830
4163;0;Drama Comedy Romance;Submarine;8,52E+15;864659;970;Submarine;74;864659
4164;0;Documentary Drama History;The Square;4892203;0;880;The Square;78;0
4165;0;Drama;Chacun sa nuit;4665026;0;950;One to Another;58;0
4166;0;Drama Music;एबीसीडी;1294967;222000;1600;ABCD (Any Body Can Dance);56;222000
4167;0;Thriller Documentary Crime History;Man on Wire;1,43E+16;2957978;940;Man on Wire;75;2957978
4168;0;Drama Thriller;Abandoned;3068463;0;820;Abandoned;58;0
4169;1900000;Drama;Brotherly Love;1367751;0;890;Brotherly Love;69;-1900000
4170;1800000;Horror Drama Thriller;The Last Exorcism;1,48E+16;67738090;870;The Last Exorcism;56;65938090
4171;0;Drama;Nowhere Boy;1950959;0;980;Nowhere Boy;72;0
4172;1800000;Drama;A Streetcar Named Desire;14884756;8000000;1250;A Streetcar Named Desire;76;6200000
4173;1800000;Drama Comedy War;Dr. Strangelove or: How I Learned to Stop Worrying and Love the Bomb;41996783;9440272;950;Dr. Strangelove or: How I Learned to Stop Worrying and Love the Bomb;80;7640272
4174;1800000;Drama Romance;El Crimen del Padre Amaro;2,18E+16;0;1180;The Crime of Padre Amaro;62;-1800000
4175;1800000;Drama Fantasy;Beasts of the Southern Wild;12471239;21107746;930;Beasts of the Southern Wild;68;19307746
4176;1700000;Action Science Fiction;Battle for the Planet of the Apes;1,33E+16;8844595;930;Battle for the Planet of the Apes;55;7144595
4177;0;Drama Music;Songcatcher;3363321;0;1090;Songcatcher;56;0
4178;2000000;Drama Thriller;Higher Ground;1,70E+16;841733;1090;Higher Ground;53;-1158267
4179;0;Comedy Romance;வாலு;320387;0;1550;Vaalu;67;0
4180;0;Comedy Documentary;The Greatest Movie Ever Sold;692497;621951;870;The Greatest Movie Ever Sold;64;621951
4181;0;Comedy;Ed and His Dead Mother;2,34E+16;0;930;Ed and His Dead Mother;55;0
4182;0;Adventure Drama Foreign;Travellers and Magicians;749699;0;1080;Travellers and Magicians;68;0
4183;1800000;Western;Hang 'em High;11756943;6800000;1140;Hang 'em High;67;5000000
4184;0;Crime Drama;Deadline - U.S.A.;225627;0;870;Deadline - U.S.A.;69;0
4185;0;Horror Thriller;Sublime;6833164;0;1130;Sublime;53;0
4186;0;Thriller Comedy Horror;A Beginner's Guide to Snuff;60127;0;870;A Beginner's Guide to Snuff;0;0
4187;1800000;Action Science Fiction;Independence Daysaster;1,96E+16;0;860;Independence Daysaster;42;-1800000
4188;1800000;Comedy Romance;Dysfunctional Friends;2,15E+16;0;1010;Dysfunctional Friends;50;-1800000
4189;1530000;Action Drama Thriller;Lola rennt;2736562;7267585;810;Run Lola Run;72;5737585
4190;500000;Drama Horror Thriller Romance;May;8650779;150277;930;May;63;-349723
4191;1493619;Adventure Family;Against the Wild;2492747;0;900;Against the Wild;49;-1493619
4192;0;Drama;La misma luna;2,76E+16;23311391;1060;Under the Same Moon;70;23311391
4193;1700000;Action Science Fiction;Conquest of the Planet of the Apes;1,88E+16;9700000;880;Conquest of the Planet of the Apes;61;8000000
4194;1700000;Drama Thriller;In the Bedroom;6,98E+16;0;1300;In the Bedroom;64;-1700000
4195;2000000;Thriller Crime Horror;I Spit on Your Grave;26281839;572809;1080;I Spit on Your Grave;63;-1427191
4196;1700000;Comedy Crime;Happy, Texas;2079125;1943649;980;Happy, Texas;55;243649
4197;0;Drama Thriller Romance;My Summer of Love;3939753;0;860;My Summer of Love;60;0
4198;1000000;Drama Romance;Dabba;14017809;4235151;1040;The Lunchbox;73;3235151
4199;0;Drama Romance;Yes;3677831;0;1000;Yes;59;0
4200;1644736;Comedy Romance;You Can't Take It With You;3426314;7433101;1260;You Can't Take It With You;72;5788365
4201;1650000;War Drama Romance;From Here to Eternity;6915201;30500000;1180;From Here to Eternity;72;28850000
4202;1600000;Western;She Wore a Yellow Ribbon;8535178;5400000;1030;She Wore a Yellow Ribbon;71;3800000
4203;0;Drama Music;Grace Unplugged;2160586;0;1020;Grace Unplugged;60;0
4204;0;Comedy Drama;Foolish;796009;6033999;840;Foolish;63;6033999
4205;0;Drama Crime Thriller;N-Secure;1,35E+16;2592808;0;N-Secure;43;2592808
4206;0;Drama Comedy Romance;سكر بنات;4554574;0;960;Caramel;68;0
4207;0;Thriller Horror;Out of the Dark;3215465;0;920;Out of the Dark;46;0
4208;0;Drama Romance;Ha-Buah;1,49E+16;0;1140;The Bubble;76;0
4209;1600000;Crime Drama Mystery;The Conversation;20810292;4420000;1130;The Conversation;75;2820000
4210;0;Romance;दिल जो भी कहे;122704;0;0;Dil Jo Bhi Kahey...;0;0
4211;0;Crime Drama Romance;La sirène du Mississipi;3654018;0;1230;Mississippi Mermaid;67;0
4212;0;Drama Mystery;I Love Your Work;3313339;0;1110;I Love Your Work;65;0
4213;0;Horror;Cabin Fever;5,38E+16;0;990;Cabin Fever;44;0
4214;2000000;Comedy;Waitress;9,67E+15;22179430;1080;Waitress;67;20179430
4215;1500000;Action;Bloodsport;1749699;11806119;920;Bloodsport;66;10306119
4216;1500000;Comedy Drama;Mr. Smith Goes to Washington;122624;9600000;1290;Mr. Smith Goes to Washington;79;8100000
4217;1500000;Drama Crime;Kids;1,33E+16;7412216;910;Kids;68;5912216
4218;1500000;Comedy Drama;The Squid and the Whale;13788054;11098131;810;The Squid and the Whale;69;9598131
4219;1000000;Comedy;Kissing Jessica Stein;3990215;10013424;970;Kissing Jessica Stein;59;9013424
4220;17000000;Action Drama;Kickboxer: Vengeance;6,53E+15;0;900;Kickboxer: Vengeance;45;-17000000
4221;1500000;Drama Mystery Thriller;Spellbound;1,11E+16;7000000;1110;Spellbound;73;5500000
4222;0;Drama Mystery;Exotica;5446832;0;1030;Exotica;65;0
4223;1500000;Romance Comedy Crime Drama;Buffalo '66;10009994;2375097;1100;Buffalo '66;71;875097
4224;1500000;Horror Thriller;Insidious;58594852;97009150;1030;Insidious;68;95509150
4225;1500000;Comedy Crime Science Fiction Thriller;Repo Man;1,14E+16;2300000;920;Repo Man;67;800000
4226;1500000;Crime Drama Thriller;Nueve Reinas;8589355;0;1140;Nine Queens;74;-1500000
4227;0;Documentary;The Gatekeepers;2828303;0;1010;The Gatekeepers;65;0
4228;1500000;Drama;The Ballad of Jack and Rose;3618646;712294;1110;The Ballad of Jack and Rose;65;-787706
4229;1500000;Comedy Romance;The To Do List;15017068;3566225;1040;The To Do List;55;2066225
4230;1500000;Action Crime Drama Thriller;Killing Zoe;5817519;418961;960;Killing Zoe;61;-1081039
4231;1500000;Drama;The Believer;9856826;416925;980;The Believer;68;-1083075
4232;0;Drama Romance;Snow Angels;4,26E+15;414404;1060;Snow Angels;65;414404
4233;0;Thriller Action Horror;Unsullied;6,12E+16;0;930;Unsullied;30;0
4234;1500000;Horror Mystery;Session 9;11064228;373967;1000;Session 9;62;-1126033
4235;0;Comedy Romance;I Want Someone to Eat Cheese With;1,74E+16;0;800;I Want Someone to Eat Cheese With;57;0
4236;0;Drama;Mooz-lum;414754;330048;950;Mooz-lum;45;330048
4237;0;Comedy Horror;Hatchet;12677016;0;830;Hatchet;57;0
4238;1;Drama Comedy;Modern Times;2827648;8500000;870;Modern Times;81;8499999
4239;0;Drama Family Comedy;Stolen Summer;87066;0;910;Stolen Summer;64;0
4240;1500000;Comedy Horror;My Name Is Bruce;75591;173066;860;My Name Is Bruce;59;-1326934
4241;1500000;Comedy;The Salon;2,03E+16;0;0;The Salon;35;-1500000
4242;1500000;Comedy;Road Hard;8,59E+15;0;970;Road Hard;66;-1500000
4243;1500000;Drama Romance;Forty Shades of Blue;71377;0;1080;Forty Shades of Blue;60;-1500000
4244;1200000;Drama History War;Amigo;193172;0;1280;Amigo;60;-1200000
4245;1500000;Horror Mystery Science Fiction;Pontypool;4680206;32000;930;Pontypool;66;-1468000
4246;2000000;Drama;Trucker;120173;0;900;Trucker;68;-2000000
4247;1;Romance Comedy Drama;Me You and Five Bucks;94105;0;900;Me You and Five Bucks;100;-1
4248;1500000;Horror Thriller;The Lords of Salem;14504326;1165882;1010;The Lords of Salem;51;-334118
4249;0;Horror Comedy Thriller;Housebound;10322858;0;1090;Housebound;65;0
4250;0;Documentary;Wal-Mart: The High Cost of Low Price;1404175;0;980;Wal-Mart: The High Cost of Low Price;69;0
4251;1;Comedy Drama Fantasy Romance Science Fiction;Fetching Cody;77876;0;870;Fetching Cody;68;-1
4252;0;Drama Comedy;Last I Heard;35819;0;980;Last I Heard;60;0
4253;9000000;Comedy Drama;Closer to the Moon;9159265;0;1120;Closer to the Moon;64;-9000000
4254;0;Science Fiction;Mutant World;1,89E+16;1500000;850;Mutant World;26;1500000
4255;0;Comedy Family Drama;Growing Up Smith;71087;0;1020;Growing Up Smith;74;0
4256;0;Thriller Action Crime;Checkmate;1105357;0;1020;Checkmate;42;0
4257;1500000;Drama Mystery Horror Thriller;#Horror;2815228;0;900;#Horror;33;-1500000
4258;0;Action Horror Thriller;Wind Walkers;446858;0;930;Wind Walkers;75;0
4259;1488423;Fantasy Animation Family;Snow White and the Seven Dwarfs;80171283;184925486;830;Snow White and the Seven Dwarfs;69;183437063
4260;1400000;Drama Foreign;La niña santa;6,85E+15;0;1060;The Holy Girl;68;-1400000
4261;1455000;Western;Shalako;3598457;2620000;1130;Shalako;54;1165000
4262;1;Adventure Comedy Horror;Incident at Loch Ness;1452152;0;940;Incident at Loch Ness;59;-1
4263;2000000;Drama;The Dog Lover;1193219;0;1010;The Dog Lover;53;-2000000
4264;3150000;Horror Thriller;GirlHouse;8039223;0;1000;GirlHouse;52;-3150000
4265;0;Drama Crime Thriller;La chambre bleue;2486992;0;750;The Blue Room;62;0
4266;0;Thriller Horror;House at the End of the Drive;43049;0;910;House at the End of the Drive;0;0
4267;1377800;Family Adventure Comedy Science Fiction Crime;Batman;9815394;0;1050;Batman;61;-1377800
4268;1350000;Comedy Crime;Lock, Stock and Two Smoking Barrels;16032594;3897569;1050;Lock, Stock and Two Smoking Barrels;75;2547569
4269;0;Western;The Ballad of Gregorio Cortez;592821;0;1040;The Ballad of Gregorio Cortez;0;0
4270;1300000;Drama;Festen;10240917;0;1050;The Celebration;77;-1300000
4271;0;Comedy Drama;Trees Lounge;3443916;0;950;Trees Lounge;67;0
4272;1300000;Drama;Vượt Sóng;7,21E+15;639000;1350;Journey from the Fall;50;-661000
4273;0;Drama;The Basket;430758;619042;1050;The Basket;65;619042
4274;0;Horror Comedy;Eddie: The Sleepwalking Cannibal;143784;1632;790;Eddie: The Sleepwalking Cannibal;61;1632
4275;0;Drama Action;Kurmanjan Datka. Queen of the Mountains;77873;0;1350;Queen of the Mountains;0;0
4276;0;Science Fiction;Def-Con 4;319792;0;880;Def-Con 4;28;0
4277;1000000;Action Comedy;The Hebrew Hammer;1600797;0;850;The Hebrew Hammer;59;-1000000
4278;0;Comedy Romance;Neal 'n' Nikki;2,85E+16;0;1220;Neal 'n' Nikki;23;0
4279;0;Comedy;The 41–Year–Old Virgin Who Knocked Up Sarah Marshall and Felt Superbad About It;5628399;0;820;The 41–Year–Old Virgin Who Knocked Up Sarah Marshall and Felt Superbad About It;32;0
4280;0;Drama Horror Romance;Forget Me Not;5065752;0;1030;Forget Me Not;50;0
4281;1288000;Drama Mystery;Rebecca;18426825;6000000;1300;Rebecca;77;4712000
4282;1250000;Horror Thriller;Friday the 13th Part 2;16517777;21722776;870;Friday the 13th Part 2;60;20472776
4283;1250000;Drama;The Lost Weekend;6903314;11000000;1010;The Lost Weekend;74;9750000
4284;1250000;Horror Science Fiction;C.H.U.D.;445544;3412497;880;C.H.U.D.;53;2162497
4285;0;Drama;Filly Brown;106949;0;1000;Filly Brown;59;0
4286;15000000;Adventure Animation Comedy Family;The Lion of Judah;165909;0;870;The Lion of Judah;58;-15000000
4287;1250000;Crime Drama Thriller;Niagara;9903992;8500000;920;Niagara;67;7250000
4288;1250000;Drama;How Green Was My Valley;7,70E+15;6000000;1180;How Green Was My Valley;68;4750000
4289;0;Thriller Comedy Romance;Da Sweet Blood of Jesus;4480579;0;1230;Da Sweet Blood of Jesus;41;0
4290;1200000;Drama;Sex, Lies, and Videotape;10869492;0;1000;Sex, Lies, and Videotape;67;-1200000
4291;1200000;Horror Mystery Crime;Saw;6,37E+16;103911669;1030;Saw;72;102711669
4292;3000000;Comedy Crime Mystery;Super Troopers;16312803;18492362;1000;Super Troopers;66;15492362
4293;1;;The Algerian;2,54E+16;0;990;The Algerian;0;-1
4294;1300000;Comedy Drama;Los insólitos peces gato;1,47E+16;0;870;The Amazing Catfish;57;-1300000
4295;0;Comedy Drama Romance;Monsoon Wedding;8109958;0;1140;Monsoon Wedding;68;0
4296;0;Drama Romance;You Can Count on Me;7142448;0;1110;You Can Count on Me;68;0
4297;1200000;Comedy Mystery Thriller;The Trouble with Harry;6,92E+15;7000000;990;The Trouble with Harry;69;5800000
4298;0;Comedy;But I'm a Cheerleader;4826908;0;850;But I'm a Cheerleader;65;0
4299;1200000;Drama;Home Run;3085411;2861020;1140;Home Run;63;1661020
4300;1200000;Crime Thriller;Reservoir Dogs;66925866;14661007;990;Reservoir Dogs;80;13461007
4301;0;Drama Family Fantasy;The Blue Bird;1280733;0;880;The Blue Bird;64;0
4302;1200000;Western;Il buono, il brutto, il cattivo;88377076;6000000;1610;The Good, the Bad and the Ugly;81;4800000
4303;0;Drama;Que Horas Ela Volta?;9683622;0;1100;The Second Mother;78;0
4304;1250000;Drama Comedy;Blue Like Jazz;16116;0;1060;Blue Like Jazz;58;-1250000
4305;0;Comedy Music;Down & Out With The Dolls;2386;0;880;Down & Out With The Dolls;0;0
4306;900000;Documentary;Pink Ribbons, Inc.;97913;25000;970;Pink Ribbons, Inc.;68;-875000
4307;1200000;Comedy;Certifiably Jonathan;47781;0;850;Certifiably Jonathan;0;-1200000
4308;1344000;Drama Romance;Q;2,04E+16;0;1030;Desire;41;-1344000
4309;0;Drama Comedy;La Navaja De Don Juan;21678;0;980;The Blade of Don Juan;0;0
4310;0;Crime Comedy Drama Adventure;Grand Theft Parsons;1998557;0;880;Grand Theft Parsons;60;0
4311;0;Comedy;Extreme Movie;8148187;0;880;Extreme Movie;39;0
4312;1200000;Action Adventure Drama War;The Charge of the Light Brigade;2968235;2736000;1150;The Charge of the Light Brigade;68;1536000
4313;0;Thriller Horror;Below Zero;136514;0;0;Below Zero;44;0
4314;1200000;;Crowsnest;57564;0;840;Crowsnest;48;-1200000
4315;2600000;Action Adventure Comedy;Airborne;8001156;2850263;910;Airborne;61;250263
4316;1200000;Action Adventure;Cotton Comes to Harlem;1079125;0;970;Cotton Comes to Harlem;67;-1200000
4317;0;Horror;The Wicked Within;1906151;0;910;The Wicked Within;42;0
4318;0;Horror;Bleeding Hearts;100533;0;0;Bleeding Hearts;20;0
4319;3000000;Comedy;Waiting...;10230583;18637690;940;Waiting...;62;15637690
4320;0;Drama Thriller Crime;Dead Man's Shoes;12818441;0;900;Dead Man's Shoes;72;0
4321;1100000;Comedy Horror;From a Whisper to a Scream;1220072;1400000;990;From a Whisper to a Scream;68;300000
4322;0;Documentary;Sex With Strangers;14406;0;0;Sex With Strangers;50;0
4323;1596010;Horror;Dracula: Pages from a Virgin's Diary;552361;0;750;Dracula: Pages from a Virgin's Diary;69;-1596010
4324;0;Drama;Faith Like Potatoes;147886;0;970;Faith Like Potatoes;60;0
4325;1100000;Fantasy Science Fiction Horror;Beyond the Black Rainbow;7717237;0;1100;Beyond the Black Rainbow;57;-1100000
4326;1100000;Action Thriller Crime;Serbuan maut;40285095;4105187;1010;The Raid;73;3005187
4327;0;Horror Science Fiction Action;The Dead Undead;249457;0;900;The Dead Undead;31;0
4328;0;Horror Documentary Mystery;The Vatican Exorcisms;447166;0;0;The Vatican Exorcisms;44;0
4329;878000;Drama Romance;Casablanca;43729123;10462500;1020;Casablanca;79;9584500
4330;0;Horror Thriller;Lake Mungo;4653047;0;840;Lake Mungo;61;0
4331;1250000;Drama Comedy Romance;Rocket Singh: Salesman of the Year;3000435;0;1560;Rocket Singh: Salesman of the Year;70;-1250000
4332;1000000;Adventure Drama Science Fiction;Silent Running;11095414;0;890;Silent Running;63;-1000000
4333;1000000;Drama;Rocky;7219808;117235147;1190;Rocky;75;116235147
4334;0;Drama;The Sleepwalker;926084;0;920;The Sleepwalker;41;0
4335;1000000;Adventure Comedy History Romance;Tom Jones;2833166;37600000;1280;Tom Jones;61;36600000
4336;1000000;Horror Thriller;Unfriended;4,20E+16;62882090;820;Unfriended;55;61882090
4337;1300000;Crime Drama;Taxi Driver;58845025;28262574;1140;Taxi Driver;80;26962574
4338;1000000;Drama Horror;The Howling;6,53E+16;17985893;910;The Howling;64;16985893
4339;950000;Adventure Action Thriller;Dr. No;48901542;59600000;1100;Dr. No;69;58650000
4340;0;Horror Thriller;Chernobyl Diaries;20649145;18112929;880;Chernobyl Diaries;49;18112929
4341;1000000;Horror;Hellraiser;22583834;14564027;940;Hellraiser;69;13564027
4342;5000000;Drama;God's Not Dead 2;696858;23507567;1210;God's Not Dead 2;57;18507567
4343;1000000;Horror Thriller;Cry_Wolf;6926926;10047674;900;Cry_Wolf;56;9047674
4344;1000000;Adventure Horror Action Science Fiction;Gojira ni-sen mireniamu;3322721;10037390;1070;Godzilla 2000;59;9037390
4345;3500000;Drama Romance;Blue Valentine;26881611;16566240;1120;Blue Valentine;69;13066240
4346;1000000;Drama;Transamerica;9773398;13350369;1030;Transamerica;69;12350369
4347;1000000;Thriller Horror;The Devil Inside;13152822;101758490;830;The Devil Inside;46;100758490
4348;2090000;Comedy Drama Thriller;Beyond the Valley of the Dolls;4289003;40000000;1090;Beyond the Valley of the Dolls;66;37910000
4349;1000000;Drama Action Western Music Romance;Love Me Tender;1444258;9000000;890;Love Me Tender;55;8000000
4350;1000000;Documentary;An Inconvenient Truth;1,41E+16;46243000;1000;An Inconvenient Truth;67;45243000
4351;1000000;Action Drama History War;Sands of Iwo Jima;3,85E+16;7800000;1000;Sands of Iwo Jima;62;6800000
4352;0;Documentary Music;Shine a Light;2162522;0;1220;Shine a Light;72;0
4353;5000000;Action Adventure Horror Thriller;The Green Inferno;1,78E+16;6833445;1000;The Green Inferno;50;1833445
4354;0;Drama Romance Family;Departure;4,26E+16;0;1090;Departure;75;0
4355;1000000;Drama Romance Comedy;The Sessions;9115486;9138338;980;The Sessions;66;8138338
4356;0;Documentary;Food, Inc.;1,50E+16;0;940;Food, Inc.;74;0
4357;0;Drama;October Baby;186221;5355847;1070;October Baby;68;5355847
4358;0;Comedy Drama Romance;Next Stop Wonderland;1334481;0;960;Next Stop Wonderland;60;0
4359;0;Drama;The Skeleton Twins;15699363;5284309;900;The Skeleton Twins;67;5284309
4360;0;Drama Thriller;Martha Marcy May Marlene;17806082;3538446;1010;Martha Marcy May Marlene;67;3538446
4361;0;Comedy Romance;Obvious Child;1012895;3123963;830;Obvious Child;67;3123963
4362;0;Drama;Frozen River;4805651;0;970;Frozen River;67;0
4363;1000000;Documentary Music;20 Feet from Stardom;5,25E+15;0;890;20 Feet from Stardom;74;-1000000
4364;1000000;Drama Romance;Two Girls and a Guy;486805;2057193;840;Two Girls and a Guy;54;1057193
4365;0;Comedy Drama Romance;Walking and Talking;3,67E+16;0;860;Walking and Talking;66;0
4366;1000000;Documentary;Who Killed the Electric Car?;5,32E+16;1678874;920;Who Killed the Electric Car?;72;678874
4367;1000000;Comedy Drama Romance;The Broken Hearts Club: A Romantic Comedy;3,42E+16;1744858;940;The Broken Hearts Club: A Romantic Comedy;63;744858
4368;1000000;Comedy Horror Thriller Mystery Fantasy;Bubba Ho-tep;9954848;0;920;Bubba Ho-tep;67;-1000000
4369;1;Drama;Slam;29245;0;1000;Slam;67;-1
4370;1000000;Crime Drama Mystery Thriller;Brigham City;2,80E+16;852206;1190;Brigham City;73;-147794
4371;1000000;Drama Foreign Romance;Fiza;43023;623791;1700;Fiza;61;-376209
4372;1000000;Comedy;Orgazmo;506516;0;940;Orgazmo;62;-1000000
4373;0;Drama Romance;All the Real Girls;365924;0;1080;All the Real Girls;59;0
4374;0;Comedy;Dream with the Fishes;9,48E+15;0;970;Dream with the Fishes;77;0
4375;1000000;Drama;Blue Car;6,73E+15;464000;920;Blue Car;67;-536000
4376;0;Drama;Palo Alto;16570708;0;1000;Palo Alto;64;0
4377;0;Crime Drama;Ajami;51799;0;1200;Ajami;68;0
4378;0;Comedy Drama Fantasy Romance;Wristcutters: A Love Story;8542921;0;880;Wristcutters: A Love Story;67;0
4379;0;Science Fiction Drama;I Origins;37555398;336472;1060;I Origins;75;336472
4380;1000000;Comedy Drama Romance;The Battle of Shaker Heights;520209;0;790;The Battle of Shaker Heights;56;-1000000
4381;1000000;Documentary;Jagal;8887411;444575;1150;The Act of Killing;75;-555425
4382;1000000;Documentary;Taxi to the Dark Side;7,49E+15;274661;1060;Taxi to the Dark Side;66;-725339
4383;1000000;Documentary;Once in a Lifetime: The Extraordinary Story of the New York Cosmos;436148;0;970;Once in a Lifetime: The Extraordinary Story of the New York Cosmos;47;-1000000
4384;0;Drama;Guiana 1838;30253;0;1200;Guiana 1838;28;0
4385;0;;Lisa Picard Is Famous;6,90E+15;0;900;Lisa Picard Is Famous;40;0
4386;1000000;Drama Adventure Documentary;Antarctica: A Year on Ice;1883947;0;920;Antarctica: A Year on Ice;72;-1000000
4387;650000;Documentary;A LEGO Brickumentary;1631274;0;930;A LEGO Brickumentary;64;-650000
4388;1000000;Drama Action;Hardflip;341461;0;1140;Hardflip;47;-1000000
4389;0;Thriller;Chocolate: Deep Dark Secrets;8,88E+15;0;2000;Chocolate: Deep Dark Secrets;34;0
4390;0;Mystery Horror;The House of the Devil;8,63E+15;0;950;The House of the Devil;60;0
4391;0;Comedy Thriller Crime;The Perfect Host;6507094;14870;930;The Perfect Host;62;14870
4392;0;Comedy Crime;Safe Men;1,19E+16;0;880;Safe Men;63;0
4393;1000000;Romance Drama Crime;Speedway Junky;340019;0;1040;Speedway Junky;52;-1000000
4394;0;Comedy Drama;The Last Big Thing;678475;0;980;The Last Big Thing;60;0
4395;0;Action Comedy;The Specials;9,06E+15;0;820;The Specials;55;0
4396;0;Comedy Romance;16 to Life;1,08E+16;0;1180;16 to Life;44;0
4397;1000000;Crime Drama Romance Thriller;Alone With Her;2175696;10018;780;Alone With Her;62;-989982
4398;1000000;Drama Science Fiction;Creative Control;150211;0;970;Creative Control;54;-1000000
4399;1000000;Drama Fantasy Science Fiction;Special;1260314;7202;810;Special;66;-992798
4400;0;;Sparkler;547654;0;960;Sparkler;0;0
4401;0;Action Comedy Science Fiction;The Helix... Loaded;206;0;970;The Helix... Loaded;48;0
4402;0;Drama Action Thriller;In Her Line of Fire;429587;0;880;In Her Line of Fire;33;0
4403;0;Comedy Drama;The Jimmy Show;98351;0;960;The Jimmy Show;80;0
4404;1000000;Crime Drama;Heli;3629777;0;1050;Heli;62;-1000000
4405;0;Family Comedy;Karachi se Lahore;6,00E+16;0;0;Karachi se Lahore;80;0
4406;900000;Drama Romance;Loving Annabelle;7145832;0;760;Loving Annabelle;64;-900000
4407;1000000;Drama Comedy;Hits;3638411;0;960;Hits;49;-1000000
4408;0;Action Crime Drama Thriller;Jimmy and Judy;1255771;0;990;Jimmy and Judy;54;0
4409;0;Comedy Romance;Frat Party;783842;0;840;Frat Party;35;0
4410;0;Drama;The Party's Over;118324;0;940;The Party's Over;61;0
4411;0;Drama;Proud;23681;0;870;Proud;55;0
4412;0;Drama;The Poker House;2,95E+16;0;930;The Poker House;61;0
4413;0;;Childless;2,44E+16;0;900;Childless;45;0
4414;0;Horror;ZMD: Zombies of Mass Destruction;1563711;0;920;ZMD: Zombies of Mass Destruction;47;0
4415;1000000;Horror Thriller;Snow White: A Deadly Summer;6,53E+15;0;850;Snow White: A Deadly Summer;48;-1000000
4416;0;Romance Drama;A escondidas;1233688;0;960;Hidden Away;76;0
4417;1000000;Comedy Drama Romance;My Last Day Without You;153625;0;900;My Last Day Without You;57;-1000000
4418;0;Comedy Romance;Steppin: The Movie;328498;0;850;Steppin: The Movie;50;0
4419;1000000;Western;Doc Holliday's Revenge;4594;0;840;Doc Holliday's Revenge;32;-1000000
4420;0;Thriller Horror;Black Rock;7207051;0;830;Black Rock;49;0
4421;0;Horror Thriller Mystery;Truth or Dare;6,68E+16;0;950;Truth or Dare;57;0
4422;0;Drama Thriller;The Pet;1284741;0;940;The Pet;53;0
4423;1000000;Science Fiction Drama Music;Bang Bang Baby;9,73E+15;0;900;Bang Bang Baby;66;-1000000
4424;1;Horror;Fear Clinic;1859965;0;950;Fear Clinic;40;-1
4425;0;Comedy Action Science Fiction Thriller;Zombie Hunter;3418372;0;930;Zombie Hunter;35;0
4426;0;Drama;A Fine Step;6,54E+15;0;900;A Fine Step;41;0
4427;950000;Drama Romance Science Fiction;Charly;1,79E+16;814666;1030;Charly;66;-135334
4428;950000;Horror Thriller;Banshee Chapter;7,31E+15;0;870;Banshee Chapter;57;-950000
4429;950000;Drama Mystery Thriller;Ask Me Anything;8976128;0;1000;Ask Me Anything;55;-950000
4430;0;Comedy Romance;And Then Came Love;280829;0;900;And Then Came Love;50;0
4431;913000;Documentary;Food Chains;7,96E+15;0;830;Food Chains;74;-913000
4432;910000;Crime Drama;On the Waterfront;1,60E+16;9600000;1080;On the Waterfront;80;8690000
4433;930000;Comedy;L!fe Happens;5974156;30905;1000;L!fe Happens;53;-899095
4434;852510;Drama;4 luni, 3 săptămîni și 2 zile;9270133;1185783;1130;4 Months, 3 Weeks and 2 Days;73;333273
4435;0;Horror;The Horror Network Vol. 1;392658;0;0;The Horror Network Vol. 1;50;0
4436;950000;Drama Thriller;Hard Candy;25918007;7022209;1030;Hard Candy;68;6072209
4437;900000;Drama Thriller;The Quiet;40971;381420;960;The Quiet;61;-518580
4438;0;Drama;Circumstance;234239;0;1070;Circumstance;74;0
4439;0;Drama;Fruitvale Station;20967146;17385830;850;Fruitvale Station;73;17385830
4440;0;Comedy Fantasy Thriller;The Brass Teapot;1,06E+16;0;1000;The Brass Teapot;58;0
4441;858000;Animation Drama Family;Bambi;47651878;267447150;700;Bambi;68;266589150
4442;0;Comedy;The Hammer;9,57E+15;0;880;The Hammer;65;0
4443;850000;Drama Comedy Romance;Latter Days;5,42E+16;819939;1070;Latter Days;67;-30061
4444;0;Drama;Le bonheur d'Elza;7,25E+15;0;780;Elza;0;0
4445;1000000;Drama;1982;1,76E+16;0;900;1982;50;-1000000
4446;850000;Comedy;For a Good Time, Call...;14238376;1243961;850;For a Good Time, Call...;58;393961
4447;0;Comedy Drama Romance;Celeste & Jesse Forever;9,44E+15;3094813;910;Celeste & Jesse Forever;64;3094813
4448;0;Comedy Drama Family Science Fiction;Time Changer;3,40E+16;0;950;Time Changer;52;0
4449;0;Crime Drama Thriller;London to Brighton;3060685;0;850;London to Brighton;65;0
4450;0;Action Comedy Science Fiction;American Hero;5023091;0;860;American Hero;50;0
4451;0;Thriller Mystery;Windsor Drive;504251;0;900;Windsor Drive;20;0
4452;800000;Drama;جدایی نادر از سیمین;12049373;0;1230;A Separation;77;-800000
4453;0;Comedy Drama Thriller;Crying with Laughter;108135;0;930;Crying with Laughter;70;0
4454;0;Comedy Drama;Welcome to the Dollhouse;5870319;0;880;Welcome to the Dollhouse;69;0
4455;800000;Drama Romance;Ruby in Paradise;59424;1001437;1140;Ruby in Paradise;56;201437
4456;800000;Drama Romance;Raising Victor Vargas;3,64E+16;2816116;880;Raising Victor Vargas;78;2016116
4457;0;Drama Thriller Romance;Die Büchse der Pandora;1824184;0;1090;Pandora's Box;76;0
4458;0;;Harrison Montgomery;6943;0;0;Harrison Montgomery;0;0
4459;0;Drama Foreign;Cama adentro;38706;0;830;Live-In Maid;78;0
4460;0;Action Drama Mystery Thriller;Deterrence;2171288;0;1010;Deterrence;61;0
4461;800000;Drama;The Mudge Boy;5292536;62852;940;The Mudge Boy;73;-737148
4462;0;Drama;The Young Unknowns;4922;0;870;The Young Unknowns;0;0
4463;0;Comedy;Not Cool;1186971;0;900;Not Cool;37;0
4464;800000;Horror Comedy;Død snø;11205726;1984662;910;Dead Snow;61;1184662
4465;780000;Action Adventure Drama History War;Saints and Soldiers;6003418;0;900;Saints and Soldiers;66;-780000
4466;0;Horror Science Fiction;Vessel;3,23E+16;0;140;Vessel;59;0
4467;777000;Comedy Drama;American Graffiti;1,93E+16;140000000;1100;American Graffiti;69;139223000
4468;0;Documentary;Iraq for Sale: The War Profiteers;1517771;0;750;Iraq for Sale: The War Profiteers;80;0
4469;0;Animation Comedy;Aqua Teen Hunger Force Colon Movie Film for Theaters;1,45E+16;0;860;Aqua Teen Hunger Force Colon Movie Film for Theaters;65;0
4470;750000;Comedy Romance Science Fiction Drama;Safety Not Guaranteed;25186002;4007792;850;Safety Not Guaranteed;68;3257792
4471;0;Comedy Documentary;Kevin Hart: Laugh at My Pain;5,50E+16;0;890;Kevin Hart: Laugh at My Pain;77;0
4472;500000;Horror Thriller Crime;Kill List;12203041;171760;950;Kill List;60;-328240
4473;750000;Horror Thriller;The Innkeepers;1,44E+16;78396;1020;The Innkeepers;54;-671604
4474;750000;Drama;Il conformista;8429295;0;1070;The Conformist;76;-750000
4475;500000;Drama Thriller;Interview with the Assassin;471264;0;880;Interview with the Assassin;56;-500000
4476;0;Horror Drama Thriller Crime;Donkey Punch;3283886;0;990;Donkey Punch;45;0
4477;750000;Horror Mystery Thriller;All the Boys Love Mandy Lane;12284939;0;900;All the Boys Love Mandy Lane;57;-750000
4478;0;Horror;Bled;1,04E+16;0;950;Bled;38;0
4479;730000;Western;High Noon;18644023;8000000;850;High Noon;76;7270000
4480;700000;Documentary;Hoop Dreams;9188431;7830611;1710;Hoop Dreams;77;7130611
4481;0;Documentary;Rize;1623769;0;860;Rize;59;0
4482;700000;Drama;L.I.E. Long Island Expressway;7731064;1667192;970;L.I.E.;67;967192
4483;0;Mystery Drama Thriller;The Sisterhood of Night;2,87E+16;0;1040;The Sisterhood of Night;65;0
4484;0;Crime Drama Music;B-Girl;631571;0;840;B-Girl;55;0
4485;700000;Drama;Half Nelson;12378031;4911725;1070;Half Nelson;65;4211725
4486;700000;Drama;Naturally Native;5,79E+15;10508;1070;Naturally Native;0;-689492
4487;0;Action Comedy Romance Science Fiction Thriller;Hav Plenty;3,14E+16;0;920;Hav Plenty;0;0
4488;750000;Thriller Crime Drama;Adulterers;1471139;0;800;Adulterers;52;-750000
4489;650;Horror Fantasy;Escape from Tomorrow;1352222;0;900;Escape from Tomorrow;48;-650
4490;0;Documentary Foreign;Starsuckers;429083;0;1030;Starsuckers;62;0
4491;0;Documentary;The Hadza:  Last of the First;45648;0;700;The Hadza:  Last of the First;0;0
4492;0;Mystery Thriller;After;4596157;0;900;After;56;0
4493;625000;Drama;Treachery;283059;0;680;Treachery;48;-625000
4494;700000;Drama Comedy;Walter;2659006;0;870;Walter;53;-700000
4495;609000;Comedy Music Romance;Top Hat;3,90E+15;3202000;1010;Top Hat;74;2593000
4496;60000;Horror Mystery;The Blair Witch Project;41690578;248000000;810;The Blair Witch Project;63;247940000
4497;600000;History Documentary Music;Woodstock;3409764;34505110;2250;Woodstock;71;33905110
4498;600000;Comedy;The Kentucky Fried Movie;10861167;0;830;The Kentucky Fried Movie;64;-600000
4499;0;Action Adventure Drama;Mercy Streets;99902;0;1060;Mercy Streets;55;0
4500;0;Thriller Mystery;Arnolds Park;6069;0;1030;Carousel of Revenge;0;0
4501;0;Drama;Broken Vessels;6,93E+15;0;900;Broken Vessels;60;0
4502;0;Crime Drama;Water & Power;350557;0;0;Water & Power;30;0
4503;522360;Music Documentary;They Will Have to Kill Us First;71349;0;1050;They Will Have to Kill Us First;50;-522360
4504;0;;Light from the Darkroom;1,29E+16;0;0;Light from the Darkroom;0;0
4505;0;Drama Comedy;Médecin de campagne;2651304;0;1020;The Country Doctor;60;0
4506;0;Thriller;The Maid's Room;1501688;0;980;The Maid's Room;48;0
4507;560000;Comedy Music;A Hard Day's Night;10730056;12299668;880;A Hard Day's Night;73;11739668
4508;56000;Documentary;The Harvest (La Cosecha);10909;0;800;The Harvest (La Cosecha);0;-56000
4509;550000;Drama Thriller;Love Letters;1586;0;980;Love Letters;46;-550000
4510;0;Comedy Drama;Julija in Alfa Romeo;6,12E+16;0;830;Juliet and Alfa Romeo;60;0
4511;500000;Drama;Fireproof;6093989;33456317;1220;Fireproof;70;32956317
4512;550000;Documentary Drama;Faith Connections;4,81E+16;0;1150;Faith Connections;42;-550000
4513;0;Adventure Family Romance;Benji;2651418;0;860;Benji;61;0
4514;130000;Drama Thriller;Open Water;15611857;54667954;790;Open Water;54;54537954
4515;0;Comedy;High Road;1292948;0;870;High Road;58;0
4516;500000;Horror Science Fiction;Kingdom of the Spiders;2537032;17000000;970;Kingdom of the Spiders;57;16500000
4517;0;Documentary Family;Mad Hot Ballroom;772668;0;1050;Mad Hot Ballroom;72;0
4518;500000;Drama Comedy;The Station Agent;11578545;8679814;880;The Station Agent;74;8179814
4519;0;Drama;To Save A Life;5,02E+16;0;1200;To Save A Life;62;0
4520;0;Documentary;Wordplay;9,06E+15;0;940;Wordplay;73;0
4521;2053648;Documentary;Beyond the Mat;2778633;500000;1020;Beyond the Mat;78;-1553648
4522;0;Comedy Drama Family Romance;The Singles Ward;9,21E+15;0;1020;The Singles Ward;75;0
4523;46000;Drama;Osama;1447734;0;830;Osama;63;-46000
4524;500000;Documentary;Sholem Aleichem: Laughing In The Darkness;109579;845188;930;Sholem Aleichem: Laughing In The Darkness;70;345188
4525;0;Drama Music Romance;Groove;109454;0;860;Groove;56;0
4526;0;Comedy Crime Family;The R.M.;82978;0;1010;The R.M.;48;0
4527;0;Drama Romance;Twin Falls Idaho;619136;0;1110;Twin Falls Idaho;70;0
4528;500000;Crime Drama;Mean Creek;8519202;603943;900;Mean Creek;69;103943
4529;0;Romance Crime Drama;Hurricane Streets;3,64E+16;0;860;Hurricane Streets;48;0
4530;0;Comedy Romance;Never Again;39077;0;980;Never Again;40;0
4531;0;Crime Drama Thriller;Civil Brand;665512;0;950;Civil Brand;53;0
4532;0;Comedy Drama Romance;Lonesome Jim;3433625;0;910;Lonesome Jim;64;0
4533;0;Romance Drama;Drinking Buddies;17378455;343341;900;Drinking Buddies;60;343341
4534;500000;Documentary;Deceptive Practice: The Mysteries and Mentors of Ricky Jay;425195;0;880;Deceptive Practice: The Mysteries and Mentors of Ricky Jay;71;-500000
4535;2000000;Action Drama;七人の侍;3,98E+16;271841;2070;Seven Samurai;82;-1728159
4536;0;Documentary;Kita svajonių komanda;388401;0;890;The Other Dream Team;69;0
4537;500000;Comedy Romance;Johnny Suede;1354816;0;970;Johnny Suede;47;-500000
4538;0;Comedy;Finishing The Game;459625;0;840;Finishing The Game;49;0
4539;500000;Comedy Drama Fantasy Horror Mystery;Rubber;9108949;98017;850;Rubber;57;-401983
4540;0;Drama Comedy Romance;Kiss the Bride;1,65E+16;0;1000;Kiss the Bride;42;0
4541;0;Drama;The Slaughter Rule;1390909;0;1120;The Slaughter Rule;62;0
4542;500000;Drama Thriller Science Fiction;Monsters;26406001;4242978;940;Monsters;62;3742978
4543;0;Drama Comedy;The Californians;218736;0;910;The Californians;40;0
4544;0;Comedy;The Living Wake;383442;0;910;The Living Wake;50;0
4545;500000;Comedy Horror;Detention of the Dead;2,39E+16;0;870;Detention of the Dead;45;-500000
4546;0;Action Comedy;疯狂的石头;168502;0;980;Crazy Stone;69;0
4547;0;Documentary Music;Scott Walker: 30 Century Man;6,08E+15;0;950;Scott Walker: 30 Century Man;70;0
4548;500000;Drama;Everything Put Together;46903;0;870;Everything Put Together;50;-500000
4549;0;Action Drama Thriller;Good Kill;10924273;316472;1040;Good Kill;59;316472
4550;0;;The Outrageous Sophie Tucker;21419;0;960;The Outrageous Sophie Tucker;0;0
4551;0;Drama Romance;Now Is Good;1,41E+16;0;1030;Now Is Good;73;0
4552;500000;Horror Comedy;Girls Gone Dead;1600171;0;1040;Girls Gone Dead;35;-500000
4553;0;;America Is Still the Place;0;0;0;America Is Still the Place;0;0
4554;0;Action Thriller Mystery;Subconscious;397323;0;1100;Subconscious;34;0
4555;0;Mystery Science Fiction Thriller;Enter Nowhere;3637857;0;900;Enter Nowhere;65;0
4556;500;Crime Drama;El Rey de Najayo;80105;0;1010;El Rey de Najayo;0;-500
4557;0;Romance Action;Fight to the Finish;251828;0;940;Fight to the Finish;52;0
4558;0;Music Horror;Alleluia! The Devil's Carnival;6,74E+15;0;0;Alleluia! The Devil's Carnival;60;0
4559;0;Thriller Comedy Mystery;The Sound and the Shadow;72359;0;900;The Sound and the Shadow;0;0
4560;0;Family;Rodeo Girl;87574;0;1080;Rodeo Girl;55;0
4561;0;Documentary;Born to Fly: Elizabeth Streb vs. Gravity;69244;0;820;Born to Fly: Elizabeth Streb vs. Gravity;50;0
4562;500000;;The Little Ponderosa Zoo;7,31E+15;0;840;The Little Ponderosa Zoo;20;-500000
4563;0;Science Fiction Action Comedy Horror;The Toxic Avenger;6672008;0;820;The Toxic Avenger;63;0
4564;0;Drama;Straight Out of Brooklyn;161517;0;0;Straight Out of Brooklyn;43;0
4565;0;Action Adventure Drama History;Bloody Sunday;7,33E+16;773228;1070;Bloody Sunday;72;773228
4566;0;;Diamond Ruff;165257;0;0;Diamond Ruff;24;0
4567;450000;Drama Romance;Conversations with Other Women;4442355;973525;840;Conversations with Other Women;62;523525
4568;0;Horror Comedy;Poultrygeist: Night of the Chicken Dead;3905877;0;1030;Poultrygeist: Night of the Chicken Dead;59;0
4569;0;;Mutual Friends;136721;0;0;Mutual Friends;0;0
4570;439000;Music Comedy Romance;42nd Street;1933366;2281000;890;42nd Street;61;1842000
4571;0;;Rise of the Entrepreneur: The Search for a Better Way;5,29E+16;0;0;Rise of the Entrepreneur: The Search for a Better Way;80;0
4572;225000;Comedy Drama;Metropolitan;1014966;0;980;Metropolitan;70;-225000
4573;0;Romance Drama Comedy Music;Så som i himmelen;4321249;0;1320;As It Is in Heaven;69;0
4574;0;Horror Drama;Roadside;160234;0;900;Roadside;42;0
4575;400000;Comedy;Napoleon Dynamite;23603514;46118097;950;Napoleon Dynamite;67;45718097
4576;0;Crime Thriller;Blue Ruin;2,53E+16;258384;900;Blue Ruin;69;258384
4577;15000;Horror Mystery;Paranormal Activity;47456823;193355800;860;Paranormal Activity;59;193340800
4578;0;Documentary;Dogtown and Z-Boys;3291609;0;910;Dogtown and Z-Boys;72;0
4579;400000;Adventure Comedy Fantasy;Monty Python and the Holy Grail;64782984;5028948;910;Monty Python and the Holy Grail;78;4628948
4580;0;Drama;Quinceañera;3,41E+16;0;900;Quinceañera;70;0
4581;0;;Gory Gory Hallelujah;3,39E+16;0;0;Gory Gory Hallelujah;10;0
4582;218;Documentary Drama;Tarnation;1063439;1162014;910;Tarnation;75;1161796
4583;0;Documentary;I Want Your Money;84344;0;920;I Want Your Money;38;0
4584;0;Horror Comedy;Love in the Time of Monsters;1,34E+16;0;0;Love in the Time of Monsters;50;0
4585;0;Horror;...E tu vivrai nel terrore! L'aldilà;8022122;0;870;The Beyond;66;0
4586;35000000;Comedy Romance;What Happens in Vegas;38100488;170000000;990;What Happens in Vegas;58;135000000
4587;500000;Horror Science Fiction Thriller;The Dark Hours;1428483;0;800;The Dark Hours;55;-500000
4588;860000;Romance Drama Comedy;My Beautiful Laundrette;3703005;2451545;970;My Beautiful Laundrette;66;1591545
4589;0;Drama Mystery Thriller;Fabled;3,35E+16;0;840;Fabled;0;0
4590;0;Drama Thriller;Show Me;2,31E+16;0;970;Show Me;56;0
4591;0;Drama;Viskningar och rop;1,13E+16;0;910;Cries and Whispers;78;0
4592;385907;Drama;Intolerance;3232447;8394751;1970;Intolerance;74;8008844
4593;0;Documentary;Trekkies;277754;0;860;Trekkies;63;0
4594;379000;Drama Music Romance;The Broadway Melody;968865;4358000;1000;The Broadway Melody;50;3979000
4595;350000;Horror;The Evil Dead;35037625;29400000;850;The Evil Dead;73;29050000
4596;6000000;Horror;Maniac;19331884;31081;890;Maniac;60;-5968919
4597;0;History Documentary;Censored Voices;59458;0;840;Censored Voices;51;0
4598;300000;Documentary;Murderball;1085909;1750211;880;Murderball;69;1450211
4599;0;Action Adventure Drama;American Ninja 2: The Confrontation;5061107;0;900;American Ninja 2: The Confrontation;49;0
4600;0;Documentary;51 Birch Street;49921;0;900;51 Birch Street;68;0
4601;350000;Science Fiction Family;Rotor DR1;249561;0;980;Rotor DR1;47;-350000
4602;350000;Drama;12 Angry Men;5,93E+16;1000000;960;12 Angry Men;82;650000
4603;0;Animation Comedy Drama;My Dog Tulip;1,17E+16;246574;830;My Dog Tulip;76;246574
4604;325000;Comedy Romance;It Happened One Night;1,19E+16;4500000;1050;It Happened One Night;77;4175000
4605;0;Drama;Κυνόδοντας;28858238;110197;940;Dogtooth;69;110197
4606;300000;Music Documentary;Tupac: Resurrection;1314576;7808524;1120;Tupac: Resurrection;80;7508524
4607;312000;Comedy Drama;Tumbleweeds;1505703;1281176;1020;Tumbleweeds;62;969176
4608;8;Fantasy Horror Thriller;The Prophecy;11818333;16;980;The Prophecy;64;8
4609;0;Comedy;Chacun Cherche Son Chat;1410387;0;910;When the Cat's Away;61;0
4610;300000;Comedy Drama;Pieces of April;4270596;0;810;Pieces of April;64;-300000
4611;0;;The Big Swap;627763;0;0;The Big Swap;0;0
4612;300000;Drama;Old Joy;1,67E+16;0;730;Old Joy;63;-300000
4613;200000;Drama;Wendy and Lucy;713906;0;800;Wendy and Lucy;64;-200000
4614;0;Drama;3 Backyards;17817;0;880;3 Backyards;48;0
4615;300000;Drama Thriller;Pierrot le fou;7791898;0;1100;Pierrot le Fou;76;-300000
4616;0;Documentary;Sisters in Law;25211;0;1040;Sisters in Law;73;0
4617;300000;Documentary;Ayurveda: Art of Being;5,59E+16;2074000;1010;Ayurveda: Art of Being;55;1774000
4618;0;Drama;Nothing But a Man;8453;0;950;Nothing But a Man;70;0
4619;300000;Drama;First Love, Last Rites;374291;40542;940;First Love, Last Rites;30;-259458
4620;0;Action Adventure Drama;Fighting Tommy Riley;4,54E+16;0;0;Fighting Tommy Riley;53;0
4621;0;Action Thriller;Royal Kill;1088501;0;900;Royal Kill;28;0
4622;0;;The Looking Glass;62979;0;1100;The Looking Glass;70;0
4623;300000;Action Comedy Science Fiction;Death Race 2000;6473667;8000000;800;Death Race 2000;59;7700000
4624;0;Horror Drama Thriller;Locker 13;1905197;0;900;Locker 13;68;0
4625;0;Horror;Midnight Cabaret;1389;0;940;Midnight Cabaret;0;0
4626;300000;Romance Comedy Drama;Anderson's Cross;6323;0;980;Anderson's Cross;0;-300000
4627;0;Drama Romance;Bizarre;583446;0;990;Bizarre;62;0
4628;0;Horror;Graduation Day;1452199;0;960;Graduation Day;50;0
4629;300000;Comedy Horror Thriller;Some Guy Who Kills People;2733725;0;970;Some Guy Who Kills People;57;-300000
4630;0;Drama Thriller Crime;Compliance;8942203;319285;900;Compliance;63;319285
4631;250000;Comedy Drama Romance;Chasing Amy;2,06E+16;12021272;1130;Chasing Amy;67;11771272
4632;250000;Comedy Drama Romance;Lovely & Amazing;145917;4186931;910;Lovely & Amazing;63;3936931
4633;0;;Death Calls;5883;0;0;Death Calls;0;0
4634;0;Crime Drama;Better Luck Tomorrow;3877036;0;1010;Better Luck Tomorrow;65;0
4635;0;Comedy Drama Romance;The Incredibly True Adventure of Two Girls In Love;170819;0;940;The Incredibly True Adventure of Two Girls In Love;57;0
4636;0;Comedy Drama;Chuck & Buck;812855;0;960;Chuck & Buck;57;0
4637;250000;Drama Comedy Romance;American Desi;126304;0;1000;American Desi;50;-250000
4638;300000;Drama Action Crime;Amidst the Devil's Wings;18087;0;900;Amidst the Devil's Wings;0;-300000
4639;250000;Thriller Science Fiction Mystery;Cube;44656151;501818;900;Cube;69;251818
4640;0;Comedy Romance;Love and Other Catastrophes;619348;0;780;Love and Other Catastrophes;58;0
4641;250;Drama Comedy Animation;I Married a Strange Person!;293649;203;720;I Married a Strange Person!;75;-47
4642;0;Drama Mystery Thriller;November;5,74E+16;0;730;November;49;0
4643;250000;Drama Romance;Like Crazy;21825564;3542353;900;Like Crazy;64;3292353
4644;0;Horror;Teeth and Blood;55325;0;960;Teeth and Blood;30;0
4645;0;Comedy;Sugar Town;375423;0;920;Sugar Town;55;0
4646;0;Drama Comedy;The Motel;120505;0;750;The Motel;70;0
4647;250000;Thriller Drama;The Canyons;6978907;56825;990;The Canyons;41;-193175
4648;0;Drama;On the Outs;4,93E+16;0;860;On the Outs;59;0
4649;0;Drama Thriller;Shotgun Stories;5251143;0;920;Shotgun Stories;69;0
4650;0;Thriller Mystery;Exam;20265518;0;1010;Exam;66;0
4651;250000;Science Fiction Drama;The Sticky Fingers of Time;130169;0;900;The Sticky Fingers of Time;48;-250000
4652;0;Music;Sunday School Musical;4,60E+16;0;930;Sunday School Musical;55;0
4653;0;Drama;Rust;399491;0;940;Rust;0;0
4654;250000;Action Fantasy;Ink;5217002;0;1060;Ink;64;-250000
4655;250000;Drama Family;The Christmas Bunny;65103;0;960;The Christmas Bunny;57;-250000
4656;0;Crime Drama;Butterfly;1063615;0;1070;Butterfly;50;0
4657;0;;UnDivided;10607;0;0;UnDivided;0;0
4658;0;Horror Thriller;The Frozen;1084387;0;0;The Frozen;42;0
4659;0;Family Drama;Horse Camp;172299;0;1080;Horse Camp;55;0
4660;0;Documentary;Give Me Shelter;278981;0;900;Give Me Shelter;0;0
4661;245000;Drama Romance War;The Big Parade;785744;22000000;1510;The Big Parade;70;21755000
4662;0;Comedy;Little Big Top;921;0;0;Little Big Top;100;0
4663;250;Romance Comedy Music;Along the Roadside;166655;0;1180;Along the Roadside;77;-250
4664;230000;Drama Action Crime;Bronson;18450613;2260712;920;Bronson;69;2030712
4665;0;Western;Western Religion;58954;0;1060;Western Religion;0;0
4666;225000;Foreign Documentary;Burn;126676;111300;860;Burn;69;-113700
4667;0;Romance Drama;Urbania;6,52E+15;0;1030;Urbania;52;0
4668;100000;Comedy;The Stewardesses;1183892;27000000;690;The Stewardesses;43;26900000
4669;210000;Adventure Horror Science Fiction;The Beast from 20,000 Fathoms;2043661;5000000;800;The Beast from 20,000 Fathoms;67;4790000
4670;400000;Adventure Action Thriller Science Fiction;Mad Max;33142185;100000000;930;Mad Max;66;99600000
4671;200000;Comedy Romance;Swingers;1,40E+16;4505922;940;Swingers;68;4305922
4672;200000;Western;Per un pugno di dollari;38771062;14500000;990;A Fistful of Dollars;76;14300000
4673;200000;Comedy;She Done Him Wrong;6,23E+15;2200000;660;She Done Him Wrong;51;2000000
4674;0;;Short Cut to Nirvana: Kumbh Mela;4998;0;850;Short Cut to Nirvana: Kumbh Mela;0;0
4675;200000;Drama;The Grace Card;616283;2295733;1010;The Grace Card;65;2095733
4676;0;Drama;Middle of Nowhere;2836537;0;1010;Middle of Nowhere;66;0
4677;0;Romance Drama Comedy;Drei;5937602;2611555;1190;Three;63;2611555
4678;200000;Music Drama;The Business of Fancydancing;6104;0;1030;The Business of Fancydancing;80;-200000
4679;0;Documentary;Call + Response;62089;0;860;Call + Response;80;0
4680;450000;Crime Horror Thriller;Malevolence;1077321;0;900;Malevolence;49;-450000
4681;0;;Reality Show;4,72E+16;0;920;Reality Show;55;0
4682;13000000;Horror;Super Hybrid;4009379;0;950;Super Hybrid;46;-13000000
4683;0;Drama Comedy Horror;Baghead;3,30E+16;0;840;Baghead;58;0
4684;0;Horror;Solitude;18716;0;890;American Beast;0;0
4685;0;Documentary;Chats perchés;92562;0;590;The Case of the Grinning Cat;77;0
4686;0;Drama;Ordet;3225189;0;1260;Ordet;78;0
4687;0;Comedy Drama Romance;Good Dick;1948435;0;860;Good Dick;61;0
4688;0;Science Fiction Drama;The Man from Earth;3,13E+16;0;870;The Man from Earth;77;0
4689;0;Documentary;The Trials Of Darryl Hunt;15066;0;1060;The Trials Of Darryl Hunt;68;0
4690;0;Drama Family;Samantha: An American Girl Holiday;4980585;0;860;Samantha: An American Girl Holiday;46;0
4691;0;Drama Mystery Science Fiction Thriller;Yesterday Was a Lie;145014;0;890;Yesterday Was a Lie;60;0
4692;0;Music Comedy Drama;Theresa Is a Mother;36532;0;1050;Theresa Is a Mother;0;0
4693;0;Thriller Drama Science Fiction;H.;1045623;0;930;H.;65;0
4694;0;Drama;Archaeology of a Woman;254659;0;940;Archaeology of a Woman;0;0
4695;180000;Drama Comedy Family;بچه‌های آسمان;7072118;900000;890;Children of Heaven;78;720000
4696;8000;Drama Romance;Weekend;1,04E+16;469947;960;Weekend;74;461947
4697;0;Comedy Romance;She's Gotta Have It;6,72E+15;0;840;She's Gotta Have It;61;0
4698;0;Documentary;Butterfly Girl;15189;0;770;Butterfly Girl;0;0
4699;0;Drama;Lumea e a mea;3,28E+16;0;1040;The World Is Mine;0;0
4700;100000;Drama Science Fiction;Another Earth;25402697;1776935;920;Another Earth;68;1676935
4701;150000;Action Drama Romance;Sweet Sweetback's Baadasssss Song;132878;15200000;970;Sweet Sweetback's Baadasssss Song;46;15050000
4702;200;Drama;Perfect Cowboy;5,10E+16;0;1090;Perfect Cowboy;50;-200
4703;150000;Comedy Drama Romance;Tadpole;8570328;2891288;780;Tadpole;55;2741288
4704;160000;Drama Music Romance;Once;1,91E+16;20710513;850;Once;73;20550513
4705;0;Drama;The Woman Chaser;619979;0;900;The Woman Chaser;49;0
4706;0;Documentary;The Horse Boy;465404;0;930;The Horse Boy;55;0
4707;0;Thriller Drama Horror;When the Lights Went Out;2805351;0;860;When the Lights Went Out;58;0
4708;0;Action Drama;Heroes of Dirt;76647;0;980;Heroes of Dirt;0;0
4709;0;Animation Family Comedy TV Movie;A Charlie Brown Christmas;8701183;0;250;A Charlie Brown Christmas;75;0
4710;0;Documentary;Antarctic Edge: 70° South;2,14E+16;0;720;Antarctic Edge: 70° South;0;0
4711;0;Documentary;Aroused;2557258;0;730;Aroused;72;0
4712;0;Documentary;Top Spin;523122;0;800;Top Spin;68;0
4713;160000;Documentary History;Roger & Me;3284903;6706368;910;Roger & Me;74;6546368
4714;0;;An American in Hollywood;15697;0;890;An American in Hollywood;0;0
4715;0;Science Fiction Drama Mystery;Sound of My Voice;6192383;0;850;Sound of My Voice;63;0
4716;0;;The Blood of My Brother: A Story of Death in Iraq;5256;0;900;The Blood of My Brother: A Story of Death in Iraq;0;0
4717;125000;Drama Comedy;Your Sister's Sister;12833247;3200000;900;Your Sister's Sister;65;3075000
4718;120000;Comedy;A Dog's Breakfast;2213889;0;880;A Dog's Breakfast;59;-120000
4719;120000;Drama Romance;Une femme mariée: Suite de fragments d'un film tourné en 1964;1112792;0;950;The Married Woman;71;-120000
4720;8500000;Drama;The Birth of a Nation;9,45E+15;15861566;1200;The Birth of a Nation;65;7361566
4721;0;Comedy;The Work and The Story;2388;0;700;The Work and The Story;0;0
4722;100000;Drama;Facing the Giants;4,56E+16;10178331;1110;Facing the Giants;66;10078331
4723;100000;Horror Thriller;The Gallows;18045782;42664410;870;The Gallows;49;42564410
4724;10000;Drama Fantasy Horror Science Fiction;Eraserhead;2,04E+16;7000000;890;Eraserhead;75;6990000
4725;0;Comedy;Hollywood Shuffle;2353483;0;780;Hollywood Shuffle;57;0
4726;0;Comedy Drama;The Mighty;5497682;0;1000;The Mighty;71;0
4727;0;Action Drama;Penitentiary;1117;0;990;Penitentiary;49;0
4728;0;Comedy Horror Science Fiction;The Lost Skeleton of Cadavra;1680525;0;900;The Lost Skeleton of Cadavra;65;0
4729;0;Family;Dude Where's My Dog?;28397;0;0;Dude Where's My Dog?;0;0
4730;0;Drama Comedy Crime;Cheap Thrills;10826253;0;850;Cheap Thrills;63;0
4731;0;Documentary;Indie Game: The Movie;7,68E+16;0;960;Indie Game: The Movie;74;0
4732;0;Thriller;Straightheads;8302951;0;880;Straightheads;52;0
4733;0;Crime Mystery Thriller;Open Secret;186401;0;680;Open Secret;70;0
4734;0;Thriller Action Drama Science Fiction;Echo Dr.;53755;0;850;Echo Dr.;50;0
4735;0;Crime Horror;The Night Visitor;74005;0;1060;The Night Visitor;73;0
4736;100;Documentary Music;The Past Is a Grotesque Animal;394575;0;770;The Past Is a Grotesque Animal;55;-100
4737;0;Documentary;Peace, Propaganda & the Promised Land;2,02E+16;0;800;Peace, Propaganda & the Promised Land;64;0
4738;60000;Mystery Drama Thriller;Pi;2,78E+16;3221152;840;Pi;71;3161152
4739;0;Comedy Romance;I Love You, Don't Touch Me!;20839;0;860;I Love You, Don't Touch Me!;60;0
4740;0;Romance Comedy;20 Dates;408073;0;870;20 Dates;37;0
4741;75000;Science Fiction;Queen Crab;140989;0;900;Queen Crab;33;-75000
4742;65000;Documentary Comedy Drama;Super Size Me;10400603;28575078;1000;Super Size Me;66;28510078
4743;0;Comedy;The FP;838957;0;820;The FP;45;0
4744;0;Comedy Drama;Happy Christmas;7052422;0;820;Happy Christmas;52;0
4745;62000;Horror Science Fiction;The Brain That Wouldn't Die;2407048;0;820;The Brain That Wouldn't Die;44;-62000
4746;0;Drama;Tiger Orange;176377;0;750;Tiger Orange;64;0
4747;0;Drama Comedy;Supporting Characters;620554;0;870;Supporting Characters;67;0
4748;70000;Mystery Horror Thriller;Absentia;6328665;0;920;Absentia;58;-70000
4749;0;Comedy Drama Romance;The Brothers McMullen;1,58E+16;0;980;The Brothers McMullen;63;0
4750;0;Drama;The Dirties;833937;0;830;The Dirties;60;0
4751;0;Drama Romance;Gabriela, Cravo e Canela;557602;0;990;Gabriela;60;0
4752;65000;Romance Comedy Drama;Tiny Furniture;2380332;416498;990;Tiny Furniture;56;351498
4753;60000;Thriller Horror;Hayride;412342;0;930;Hayride;51;-60000
4754;0;Drama Comedy Family;The Naked Ape;77577;0;1100;The Naked Ape;50;0
4755;50000;Documentary;Counting;293587;0;1110;Counting;83;-50000
4756;50000;Horror Thriller Fantasy;The Call of Cthulhu;1777148;0;470;The Call of Cthulhu;69;-50000
4757;0;Documentary;Bending Steel;48726;0;930;Bending Steel;50;0
4758;4000000;Thriller Science Fiction;The Signal;27662696;600896;950;The Signal;58;-3399104
4759;50000;Documentary;The Image Revolution;54562;0;810;The Image Revolution;57;-50000
4760;0;Drama;This Is Martin Bonner;76368;0;830;This Is Martin Bonner;66;0
4761;0;Comedy;A True Story;9,70E+15;0;960;A True Story;68;0
4762;0;Drama;George Washington;2058834;0;890;George Washington;64;0
4763;0;Comedy Romance;Smiling Fish & Goat On Fire;734;0;900;Smiling Fish & Goat On Fire;70;0
4764;0;Thriller Drama Science Fiction;Dawn of the Crescent Moon;49469;0;950;Dawn of the Crescent Moon;20;0
4765;0;Horror;Raymond Did It;160779;0;830;Raymond Did It;32;0
4766;0;Documentary Music;The Last Waltz;3,28E+16;321952;1170;The Last Waltz;79;321952
4767;50000;Thriller Horror;Run, Hide, Die;595809;0;750;Run, Hide, Die;35;-50000
4768;0;Drama Romance;The Exploding Girl;611081;0;800;The Exploding Girl;64;0
4769;0;Action Western;The Legend of God's Gun;3582;0;780;The Legend of God's Gun;0;0
4770;500000;Drama Comedy;Mutual Appreciation;1,23E+16;0;1090;Mutual Appreciation;61;-500000
4771;0;Horror;Her Cry: La Llorona Investigation;56459;0;890;Her Cry: La Llorona Investigation;0;0
4772;31192;Drama Action Comedy;Down Terrace;1330379;10000;890;Down Terrace;63;-21192
4773;27000;Comedy;Clerks;19748658;3151130;920;Clerks;74;3124130
4774;27000;Drama Romance;Pink Narcissus;2,78E+16;0;640;Pink Narcissus;60;-27000
4775;0;Drama Comedy;Funny Ha Ha;362633;76901;850;Funny Ha Ha;63;76901
4776;0;Comedy Drama;In the Company of Men;2634007;0;970;In the Company of Men;68;0
4777;0;Drama;Manito;39264;0;780;Manito;55;0
4778;0;Action Drama Crime Thriller;Rampage;7101197;0;850;Rampage;60;0
4779;0;Comedy;Slacker;3320622;0;970;Slacker;64;0
4780;0;Thriller Crime Drama;Dutch Kills;38143;0;900;Dutch Kills;0;0
4781;22000;Comedy Romance;Dry Spell;48948;0;900;Dry Spell;60;-22000
4782;0;Drama Family;Flywheel;1048524;0;1200;Flywheel;68;0
4783;0;Thriller Horror;Backmask;3619167;0;910;Backmask;47;0
4784;0;Drama Comedy Romance;The Puffy Chair;1243955;0;850;The Puffy Chair;62;0
4785;0;Drama;Stories of Our Lives;3,28E+16;0;600;Stories of Our Lives;0;0
4786;0;Comedy Romance;Breaking Upwards;67457;0;880;Breaking Upwards;56;0
4787;0;Science Fiction Thriller;All Superheroes Must Die;3,55E+16;0;780;All Superheroes Must Die;42;0
4788;12000;Horror Comedy Crime;Pink Flamingos;4553644;6000000;930;Pink Flamingos;62;5988000
4789;0;Drama;Clean;1464566;0;1110;Clean;67;0
4790;0;Drama Foreign;دایره;1,19E+16;0;900;The Circle;66;0
4791;13;Horror;Tin Can Man;332679;0;840;Tin Can Man;20;-13
4792;20000;Crime Horror Mystery Thriller;キュア;212443;99000;1110;Cure;74;79000
4793;0;Drama;On The Downlow;29757;0;900;On The Downlow;60;0
4794;0;Thriller Horror Comedy;Sanctuary: Quite a Conundrum;1,67E+16;0;820;Sanctuary: Quite a Conundrum;0;0
4795;0;Drama;Bang;9,18E+15;0;980;Bang;60;0
4796;7000;Science Fiction Drama Thriller;Primer;23307949;424760;770;Primer;69;417760
4797;0;Foreign Thriller;Cavite;22173;0;800;Cavite;75;0
4798;220000;Action Crime Thriller;El Mariachi;14269792;2040920;810;El Mariachi;66;1820920
4799;9000;Comedy Romance;Newlyweds;642552;0;850;Newlyweds;59;-9000
4800;0;Comedy Drama Romance TV Movie;Signed, Sealed, Delivered;1444476;0;1200;Signed, Sealed, Delivered;70;0
4801;0;;Shanghai Calling;857008;0;980;Shanghai Calling;57;0
4802;0;Documentary;My Date with Drew;1,93E+16;0;900;My Date with Drew;63;0
